map/FinalMap.map
8	8	8	8	8	8	8	8	8	8	8	8	8	8	8	8	8	8	8	8	8	8	14	14	14	14	14	8	8	8	8	8	8	17	4	4	4	4	4	17	17	17	17	17	17	17	17	17	17	17	17	17	17	17	17	17	17	17	17	17	17	17	17	17
8	14	14	14	14	14	14	14	14	14	14	14	14	14	14	14	8	53	53	53	53	53	14	14	14	14	14	53	53	53	53	53	8	17	4	4	4	4	4	17	17	4	4	4	4	4	4	4	4	4	4	4	4	4	4	4	4	4	4	4	4	4	17	17
8	14	14	14	14	14	14	14	14	14	14	14	14	14	14	14	8	14	14	14	14	14	14	14	14	14	14	14	14	14	14	14	8	17	4	4	4	4	4	17	4	4	4	4	4	4	4	4	4	4	4	4	4	4	4	4	4	4	4	4	4	4	4	17
8	14	14	14	14	14	14	14	14	14	14	14	14	14	14	14	8	14	14	14	14	14	14	14	14	14	14	14	14	14	14	14	8	17	4	4	4	4	4	17	4	4	4	4	4	17	17	17	17	17	17	17	17	17	17	17	17	17	17	17	4	4	4	17
8	14	14	14	14	14	14	14	14	14	14	14	14	14	14	14	8	14	14	14	14	14	8	14	14	14	8	14	14	14	14	14	8	17	4	4	4	4	4	17	4	4	4	4	17	17	17	17	17	17	17	17	17	17	17	17	17	17	17	17	17	4	4	17
8	8	8	8	8	8	8	8	8	8	8	8	8	14	14	14	8	14	14	14	14	8	8	14	14	14	8	8	14	14	14	14	8	17	4	4	4	4	4	17	4	4	4	17	17	17	4	4	4	4	4	4	4	4	4	4	4	4	17	17	17	4	4	17
8	14	14	14	14	14	14	14	14	14	14	14	14	14	14	14	8	14	14	14	8	8	50	14	14	14	51	8	14	14	14	14	8	17	4	4	4	4	4	4	4	4	4	17	17	4	4	4	4	4	4	4	4	4	4	4	4	4	17	17	4	4	4	17
8	14	14	14	14	14	14	14	14	14	14	14	14	14	14	14	8	14	14	14	8	8	50	14	14	14	51	8	8	14	14	14	8	17	4	4	4	4	4	4	4	4	4	17	17	4	4	4	17	17	4	4	17	17	4	4	4	4	17	17	4	4	4	17
8	8	8	8	8	14	14	14	14	14	14	14	8	8	8	8	8	14	14	8	8	50	14	14	14	14	14	51	8	8	14	14	8	17	4	4	4	4	4	4	4	4	4	4	4	4	4	4	17	4	4	4	4	17	4	4	4	4	17	17	4	4	4	17
8	8	8	8	8	8	50	14	14	14	51	8	8	8	8	8	8	14	14	8	8	50	14	14	14	14	14	51	8	8	14	14	8	17	4	4	4	4	4	4	4	4	4	4	4	4	4	4	17	4	4	4	4	17	4	4	4	17	17	17	4	4	4	17
8	53	53	14	14	8	50	14	14	14	51	8	14	14	53	53	8	14	14	8	50	14	14	14	14	14	14	14	51	8	14	14	8	17	4	4	4	4	4	4	4	4	4	4	4	4	4	4	4	17	17	17	17	4	4	4	4	17	17	17	4	4	4	17
8	14	14	14	14	8	50	14	14	14	51	8	14	14	14	14	8	14	14	8	50	14	14	14	14	14	14	14	51	8	14	14	8	17	17	17	17	17	17	17	17	17	4	4	4	4	4	4	4	4	4	4	4	4	4	4	17	17	17	4	4	4	4	17
8	14	14	14	14	8	50	14	14	14	51	8	14	14	14	14	8	14	14	8	50	14	8	14	14	14	8	14	51	8	14	14	8	17	17	17	17	17	17	17	17	17	17	4	4	4	17	17	4	4	4	4	4	4	17	17	17	17	4	4	4	4	4	17
8	14	14	8	8	8	50	14	14	14	51	8	8	8	14	14	8	14	14	8	50	14	8	8	8	8	8	14	51	8	14	14	8	17	17	4	4	4	4	4	4	4	4	4	4	4	17	17	4	4	4	4	4	4	17	17	17	4	4	4	4	4	4	17
8	14	14	14	14	8	50	14	14	14	51	8	14	14	14	14	8	14	14	8	50	14	14	14	14	14	14	14	51	8	14	14	8	17	4	4	4	4	4	4	4	4	4	4	4	4	17	17	17	4	4	17	17	17	17	17	17	4	4	4	4	4	4	17
8	14	14	14	51	8	50	14	14	14	51	8	50	14	14	14	8	14	14	8	8	14	14	14	14	14	14	14	8	8	14	14	8	17	4	4	4	17	17	17	17	17	17	4	4	4	17	17	17	17	17	17	17	17	17	4	4	4	4	4	4	4	4	17
8	14	14	14	14	14	14	14	14	14	14	14	14	14	14	14	8	14	14	8	8	14	14	14	14	14	14	14	8	8	14	14	8	17	4	4	17	17	17	17	17	17	17	17	4	4	4	17	17	17	17	17	4	4	4	4	4	17	17	17	17	17	17	17
8	14	14	14	14	14	14	14	14	14	14	14	14	14	14	14	8	14	14	14	8	8	50	14	14	14	51	8	8	14	14	14	8	17	4	4	17	17	17	38	38	38	38	17	4	4	4	4	4	4	4	4	4	4	4	4	17	17	4	4	4	4	4	17
8	8	8	8	14	14	8	14	14	14	8	14	14	8	8	8	8	14	14	14	14	8	50	14	14	14	51	8	14	14	14	14	8	17	4	4	17	17	38	4	4	4	4	17	4	4	4	4	4	4	4	4	4	4	17	17	17	4	4	4	4	4	4	17
8	14	14	8	14	14	8	14	14	14	8	14	14	8	14	14	8	14	14	14	14	8	8	14	14	14	8	8	14	14	14	14	8	17	4	4	17	17	4	4	4	4	4	17	17	17	4	4	4	4	4	4	4	17	17	17	17	4	4	4	4	4	4	17
8	14	14	53	14	14	8	8	14	8	8	14	14	53	14	14	8	14	14	14	14	14	8	14	14	14	8	14	14	14	14	14	8	17	4	4	17	17	4	4	4	4	17	17	4	17	4	4	4	4	4	36	17	4	4	4	4	4	4	4	4	4	4	17
8	14	14	14	14	14	14	7	7	7	14	14	14	14	14	14	8	14	14	14	14	14	14	14	14	14	14	14	14	14	14	14	8	17	4	4	17	17	4	4	4	17	17	4	4	17	4	4	4	4	4	36	17	4	4	4	4	4	17	17	17	4	4	17
8	14	14	14	14	14	14	14	7	14	14	14	14	14	14	14	8	52	52	14	14	14	14	14	14	14	14	14	14	14	52	52	8	17	4	4	17	17	4	4	17	17	4	4	4	4	4	4	4	4	4	36	17	4	4	4	17	17	17	17	17	4	4	17
8	8	8	8	8	14	14	14	14	14	14	14	8	8	8	8	8	8	8	8	8	8	14	14	14	14	14	8	8	8	8	8	8	17	4	4	17	17	4	4	17	4	4	4	4	4	4	4	4	4	4	36	17	4	4	4	17	17	4	4	17	4	4	17
8	53	53	53	8	8	14	14	14	14	14	8	8	53	53	53	8	14	14	14	14	14	14	14	14	14	14	14	14	14	14	14	8	17	4	4	17	17	4	17	17	4	4	4	4	4	4	4	4	4	4	36	17	4	4	4	17	4	4	4	4	4	4	17
8	14	14	14	14	8	8	14	14	14	8	8	14	14	14	14	8	14	8	8	8	8	8	14	14	14	8	8	8	8	8	14	8	17	4	4	17	17	4	17	4	4	17	4	4	17	4	4	4	4	17	17	17	4	4	4	17	4	4	4	4	4	4	17
8	14	14	14	14	14	8	14	14	14	8	14	14	14	14	14	8	14	14	8	8	8	50	14	14	14	51	8	8	8	14	14	8	17	4	4	17	17	4	17	4	4	17	4	4	17	4	4	4	17	17	17	17	4	4	4	17	4	4	4	4	4	4	17
8	14	14	14	14	14	14	14	14	14	14	14	14	14	14	14	8	14	14	14	8	8	50	14	14	14	51	8	8	14	14	14	8	17	4	4	17	17	4	17	17	17	17	4	4	17	4	17	17	17	4	17	17	17	4	4	17	4	4	4	4	4	4	17
8	8	8	14	14	14	14	14	14	14	14	14	14	14	8	8	8	14	14	14	14	14	14	14	14	14	14	14	14	14	14	14	8	17	4	4	17	17	4	4	4	21	17	4	4	17	17	17	4	4	4	17	17	17	4	4	17	17	4	4	4	4	4	17
8	14	8	8	14	14	14	14	14	14	14	14	14	8	8	14	8	14	14	14	14	14	14	14	14	14	14	14	14	14	14	14	8	17	4	4	17	17	4	4	4	21	17	4	4	17	17	4	4	4	4	17	4	17	4	4	4	17	17	17	17	17	17	17
8	14	14	8	8	14	14	14	14	14	14	14	8	8	14	14	8	14	14	51	8	8	50	14	14	14	51	8	8	50	14	14	8	17	4	4	17	17	4	4	4	21	17	4	4	4	4	4	4	4	4	17	4	17	17	4	4	4	4	4	4	4	4	17
8	14	14	14	14	14	8	8	14	8	8	14	14	14	14	14	8	14	14	51	8	8	50	14	14	14	51	8	8	50	14	14	8	17	4	4	17	17	4	4	4	21	17	4	4	4	4	4	4	4	4	17	4	4	17	4	4	4	4	4	4	4	4	17
8	14	14	14	14	14	8	14	14	14	8	14	14	14	14	14	8	14	14	51	8	8	8	14	14	14	8	8	8	50	14	14	8	17	4	4	17	17	4	4	4	21	17	17	17	17	4	4	17	4	4	17	4	4	17	4	4	4	4	4	4	4	4	17
8	14	14	14	14	8	8	14	14	14	8	8	14	14	14	14	8	14	14	51	8	8	8	8	14	8	8	8	8	50	14	14	8	17	4	4	17	17	4	4	4	4	4	4	4	17	4	4	17	4	4	17	4	4	17	17	4	4	4	4	4	4	4	17
8	14	14	14	14	8	14	14	14	14	14	8	14	14	14	14	8	14	14	14	14	14	14	14	14	14	14	14	14	14	14	14	8	17	4	4	17	17	4	4	4	4	4	4	4	17	17	17	17	4	4	17	4	4	4	17	17	17	17	17	4	4	4	17
8	50	14	14	8	8	14	14	14	14	14	8	8	14	14	51	8	14	14	14	14	14	14	14	14	14	14	14	14	14	14	14	8	17	4	4	17	17	4	4	4	4	4	4	4	4	4	4	17	4	4	17	4	4	4	4	4	4	4	17	17	4	4	17
8	50	14	14	8	8	14	8	14	8	14	8	8	14	14	51	8	14	14	14	14	14	14	14	14	14	14	14	14	14	14	14	8	17	4	4	17	17	4	4	4	4	4	4	4	4	4	4	17	4	4	17	4	4	4	4	4	4	4	4	17	4	4	17
8	50	14	14	8	8	14	8	8	8	14	8	8	14	14	51	8	14	14	51	8	8	8	8	14	8	8	8	8	50	14	14	8	17	4	4	17	17	4	4	4	4	4	4	4	4	4	4	17	4	4	17	4	4	4	4	4	4	4	4	17	4	4	17
8	50	14	14	8	8	14	14	14	14	14	8	8	14	14	51	8	14	14	51	8	8	8	14	14	14	8	8	8	50	14	14	8	17	4	4	17	17	4	4	4	4	17	17	17	17	17	17	17	4	4	17	17	17	17	17	17	4	4	4	17	4	4	17
8	14	14	14	8	8	14	14	14	14	14	8	8	14	14	14	8	14	14	51	8	8	14	14	14	14	14	8	8	50	14	14	8	17	4	4	17	17	4	4	4	4	4	4	4	4	17	17	17	4	4	17	17	17	17	17	17	4	4	4	17	4	4	17
8	14	14	14	8	8	14	14	14	14	14	8	8	14	14	14	8	14	14	51	8	8	14	14	14	14	14	8	8	50	14	14	8	17	4	4	17	17	4	4	4	4	4	4	4	4	4	4	4	4	4	4	4	4	4	4	4	4	4	4	17	4	4	17
8	14	14	51	8	8	14	14	14	14	14	8	8	50	14	14	8	14	14	14	14	14	14	8	14	8	14	14	14	14	14	14	8	17	4	4	17	17	4	4	4	4	4	4	4	4	4	4	4	4	4	4	4	4	4	4	4	4	4	4	17	4	4	17
8	14	14	51	8	8	14	14	14	14	14	8	8	50	14	14	8	14	14	14	14	14	14	8	8	8	14	14	14	14	14	14	8	17	4	4	17	17	17	37	37	4	4	4	4	37	37	37	37	4	4	37	37	37	37	4	4	4	37	17	17	4	4	17
8	14	14	8	8	8	8	14	14	14	8	8	8	8	14	14	8	14	14	14	8	8	14	14	14	14	14	8	8	14	14	14	8	17	4	4	17	17	17	17	17	17	17	17	17	17	17	17	17	17	17	17	17	17	17	17	17	17	17	17	4	4	4	17
8	14	14	14	14	14	14	14	14	14	14	14	14	14	14	14	8	14	14	8	8	8	14	14	14	14	14	8	8	8	14	14	8	17	4	4	4	17	17	17	17	17	17	17	17	17	17	17	17	17	17	17	17	17	17	17	17	17	4	4	4	4	4	17
8	8	14	14	14	14	14	14	14	14	14	14	14	14	14	8	8	14	8	8	8	8	8	14	14	14	8	8	8	8	8	14	8	17	4	4	4	4	4	4	4	4	4	4	4	4	4	4	4	4	4	4	4	4	4	4	4	4	4	4	4	4	4	17
8	8	8	8	52	52	14	14	14	14	14	52	52	8	8	8	8	14	14	14	14	14	14	14	14	14	14	14	14	14	14	14	8	17	4	4	4	4	4	4	4	4	4	4	4	4	4	4	4	4	4	4	4	4	4	4	4	4	4	4	4	4	4	17
8	8	8	8	8	8	14	14	14	14	14	8	8	8	8	8	8	8	8	8	8	8	14	14	14	14	14	8	8	8	8	8	8	17	17	17	17	17	17	17	17	17	17	17	17	17	17	17	17	17	17	17	17	17	17	17	17	17	17	17	17	17	17	17
0
125 81 3 82 3 83 3 84 3 85 3 91 3 92 3 93 3 94 3 95 3 406 0 410 1 470 0 474 1 533 0 539 1 582 0 586 1 597 0 603 1 641 3 642 3 646 0 650 1 654 3 655 3 660 0 668 1 710 0 714 1 724 0 732 1 774 0 778 1 788 0 796 1 838 0 842 1 852 0 860 1 902 0 906 1 916 0 924 1 964 1 966 0 970 1 972 0 1110 0 1114 1 1127 3 1128 3 1129 3 1130 3 1174 0 1178 1 1190 3 1283 3 1293 3 1331 1 1395 1 1425 2 1426 2 1438 2 1439 2 1459 1 1523 1 1537 3 1538 3 1539 3 1549 3 1550 3 1551 3 1587 1 1686 0 1690 1 1750 0 1754 1 1939 1 1942 0 1946 1 1949 0 2003 1 2006 0 2010 1 2013 0 2067 1 2077 0 2131 1 2141 0 2241 0 2255 1 2305 0 2319 1 2369 0 2383 1 2387 1 2397 0 2433 0 2447 1 2451 1 2461 0 2515 1 2525 0 2579 1 2589 0 2627 1 2637 0 2691 1 2701 0 2727 2 2728 2 2733 2 2734 2 2735 2 2736 2 2739 2 2740 2 2741 2 2742 2 2746 2 2948 2 2949 2 2955 2 2956 2 
4 640 1520 map/dragon_boss_map.map 0 1 1 1920 880 map/robot_boss_map.map 0 1 1 1920 3120 map/lava_boss_map.map 0 1 1 4560 2000 map/sigma_.map 0 1 1
0
273 109 1 117 2 122 0 134 0 135 0 138 0 139 0 170 1 177 2 179 0 184 0 212 0 220 0 275 0 285 0 338 0 350 0 368 0 373 0 385 0 386 0 402 0 414 0 449 0 450 0 466 0 478 0 504 0 549 0 551 0 557 0 561 2 562 1 563 2 564 0 573 0 612 0 614 0 616 0 625 1 626 2 627 0 628 2 662 1 666 2 695 0 707 0 708 0 716 0 717 0 726 1 730 2 750 0 765 0 785 0 799 0 818 0 820 0 829 0 833 0 847 0 893 0 897 0 911 0 954 0 955 0 956 0 957 0 958 0 961 0 975 0 981 1 982 1 986 2 987 2 1045 1 1046 1 1050 2 1051 2 1106 0 1118 0 1135 0 1148 2 1170 0 1182 0 1210 2 1212 2 1217 0 1218 0 1223 0 1224 0 1225 0 1230 0 1231 0 1234 0 1246 0 1256 1 1257 1 1263 0 1265 0 1273 2 1275 2 1288 0 1299 0 1309 0 1319 1 1320 1 1321 1 1364 0 1372 0 1383 1 1391 0 1394 0 1397 0 1401 2 1452 0 1456 0 1457 0 1463 0 1515 0 1525 2 1578 0 1580 0 1582 0 1590 0 1591 2 1640 1 1641 1 1648 0 1653 2 1660 1 1661 2 1665 1 1666 1 1678 2 1679 2 1688 0 1704 1 1705 1 1719 0 1724 1 1725 2 1729 1 1730 1 1742 2 1743 2 1772 0 1788 2 1789 1 1799 0 1800 0 1801 0 1812 0 1813 0 1816 0 1819 0 1820 0 1852 1 1853 2 1863 0 1864 0 1865 0 1944 0 1969 0 2001 1 2015 1 2023 0 2028 0 2041 0 2050 0 2051 2 2061 2 2062 0 2072 0 2094 2 2095 2 2100 2 2101 2 2105 0 2106 0 2107 0 2108 0 2109 0 2114 0 2115 1 2125 1 2126 0 2151 0 2158 2 2159 2 2162 0 2164 2 2165 2 2173 0 2182 2 2183 2 2185 1 2186 1 2246 2 2247 2 2249 1 2250 1 2258 1 2260 0 2261 0 2262 0 2266 0 2267 0 2268 0 2270 1 2280 0 2282 1 2307 0 2317 0 2345 1 2347 0 2349 0 2353 0 2358 0 2359 0 2360 0 2361 0 2371 0 2381 0 2425 0 2435 0 2445 0 2471 0 2490 0 2503 2 2505 2 2513 1 2520 0 2527 1 2535 0 2536 0 2546 0 2553 0 2554 0 2567 1 2568 0 2569 1 2600 0 2601 0 2602 0 2603 0 2615 0 2616 0 2617 0 2625 0 2631 0 2632 1 2633 0 2639 0 2679 0 2689 0 2703 0 2706 2 2718 2 2753 0 2767 0 2823 0 2825 0 2839 0 2840 0 2841 0 2888 0 2904 0 2951 0 2953 0 2967 0 2968 0 2969 0 
0
0
116 136 2 139 2 142 1 175 0 176 0 179 0 183 0 210 2 211 2 221 2 222 2 262 0 266 0 270 1 338 1 414 1 450 0 452 0 486 2 488 2 549 2 553 1 574 1 648 1 663 1 665 1 701 1 799 1 829 1 833 1 847 1 898 1 904 1 910 1 913 1 984 1 1019 0 1021 0 1048 1 1089 0 1090 0 1102 0 1211 2 1213 2 1234 2 1235 2 1245 2 1246 2 1256 2 1315 1 1319 2 1328 1 1398 1 1409 0 1411 0 1421 0 1423 0 1455 1 1654 1 1698 1 1712 0 1730 0 1742 0 1799 2 1802 2 1816 1 1864 1 1876 0 1877 0 1883 0 1884 0 1938 1 1950 1 2041 2 2043 2 2045 2 2114 1 2126 1 2197 2 2204 2 2207 1 2211 1 2215 1 2218 2 2257 1 2295 2 2325 0 2326 0 2331 0 2344 2 2345 1 2366 1 2411 0 2412 0 2413 0 2421 0 2422 0 2490 1 2557 1 2568 1 2594 1 2632 1 2641 2 2655 2 2705 2 2719 2 2882 0 2883 0 2893 0 2894 0 2927 2 2932 2 2937 2 2979 0 2981 0 2985 0 	
0
4 480 3760 1 1920 0 0 1760 0 1 -1 -1 0 1760 3760 1 2880 0 0 2720 0 1 -1 -1 0
none
10000 10000 1 1
4880 2240