map/Maze.map
3	27	27	27	27	27	27	27	27	27	27	27	27	27	27	27	27	27	27	27	27	27	27	27	27	27	27	27	27	27	27	3	3	27	27	27	27	27	27	27	27	3	3	27	27	27	27	27	27	27	27	27	27	3	3	27	27	27	27	27	27	27	27	3
26	4	4	4	4	4	4	4	4	4	4	4	4	4	4	4	4	4	4	4	4	4	4	4	4	4	4	4	4	4	4	25	26	4	4	4	4	4	4	4	4	25	26	4	4	4	4	4	4	4	4	4	4	25	26	4	4	4	4	4	4	4	4	25
26	4	4	4	4	4	4	4	4	4	4	4	4	4	4	4	4	4	4	4	4	4	4	4	4	4	4	4	4	4	4	29	30	4	4	28	2	31	4	4	4	29	30	4	4	4	4	4	4	4	4	4	4	25	26	4	4	4	4	4	4	4	4	25
3	2	2	2	2	31	4	4	28	2	2	2	2	2	2	31	4	4	28	31	4	4	28	31	4	4	28	2	2	31	4	4	4	4	4	25	3	26	4	4	4	4	4	4	4	28	2	31	4	4	4	28	2	3	26	4	4	28	2	2	2	2	2	3
3	27	27	27	3	26	4	4	29	27	3	3	27	27	3	26	4	4	25	26	4	4	25	26	4	4	29	27	3	26	4	4	4	4	4	25	3	3	2	31	4	4	4	4	4	25	3	30	4	4	4	25	3	27	30	4	4	25	3	27	3	3	27	3
26	38	38	38	25	26	4	4	4	4	29	30	38	38	25	26	4	4	29	30	4	4	25	26	4	4	4	4	25	26	4	28	31	4	4	29	27	27	27	3	31	4	4	4	4	25	26	4	4	28	2	27	30	4	4	4	4	25	26	4	25	26	4	25
26	4	4	4	25	26	4	4	4	4	4	4	4	4	25	26	4	4	4	4	4	4	25	26	4	4	4	28	3	30	4	25	26	4	4	4	4	4	4	25	26	37	37	37	37	25	26	4	4	25	26	4	4	4	4	4	4	25	26	4	29	30	4	25
26	4	4	4	25	3	2	31	4	4	4	4	4	4	25	26	4	4	4	4	4	4	25	26	4	4	4	25	26	4	4	29	3	2	2	2	31	4	4	25	3	2	2	2	2	3	3	2	2	3	3	2	2	2	31	4	4	25	26	4	4	4	4	25
26	4	4	4	25	3	27	30	4	4	28	31	4	4	25	26	4	4	4	4	45	45	25	26	37	37	37	25	26	4	4	4	29	27	27	3	26	4	4	29	27	27	27	3	3	27	27	27	27	3	3	3	27	3	26	4	4	25	3	2	2	31	4	25
26	4	4	4	25	26	4	4	4	4	25	26	37	37	25	26	4	4	28	2	2	2	3	3	2	2	2	3	3	2	31	4	4	4	4	25	26	4	4	4	4	4	4	25	26	4	4	4	36	25	3	26	4	29	30	4	4	29	27	27	27	30	4	25
26	4	4	4	29	30	4	4	4	28	3	3	2	2	27	30	4	4	25	3	27	27	3	3	27	27	27	27	27	3	26	4	4	4	4	25	26	4	4	4	4	4	4	25	26	4	4	4	36	25	3	26	4	4	4	4	4	4	4	4	4	4	4	25
26	4	4	4	4	4	4	4	28	3	27	27	27	30	4	4	4	4	25	26	4	4	25	26	47	4	4	4	4	25	3	2	2	2	2	3	26	4	4	4	4	4	4	25	26	4	4	28	2	3	3	26	4	4	4	4	4	4	4	4	4	4	4	25
26	4	4	4	4	4	4	4	25	26	4	4	4	4	4	4	37	37	25	26	4	4	25	26	47	4	4	4	4	25	3	27	27	27	27	27	30	4	4	28	31	4	4	25	26	4	4	25	3	27	27	27	2	2	31	4	4	4	4	4	4	4	4	25
26	4	4	4	28	2	2	2	3	3	2	2	2	2	2	2	2	2	3	26	4	4	25	3	2	31	4	4	4	25	26	4	4	4	4	4	4	4	4	25	26	4	4	25	26	4	4	29	30	38	38	38	29	27	30	4	4	4	4	28	31	4	4	25
26	4	4	4	25	3	27	27	27	27	27	27	27	27	27	27	27	27	27	30	4	4	25	3	27	30	4	4	4	25	26	4	4	4	4	4	4	4	4	25	26	4	4	25	26	4	4	4	4	4	4	4	4	4	4	4	4	4	4	25	26	4	4	25
26	4	4	4	25	26	4	4	4	4	4	4	4	4	4	4	4	4	4	4	4	4	25	26	47	4	4	4	4	25	26	4	4	4	28	31	4	4	28	3	30	4	4	29	30	4	4	28	2	2	2	2	2	2	31	4	4	4	4	25	26	4	4	25
26	37	37	37	25	26	4	4	4	4	4	4	4	4	4	4	4	4	4	4	4	4	25	26	47	4	4	4	4	25	26	4	4	4	25	26	37	37	25	30	4	4	4	4	4	4	28	3	27	27	27	27	27	27	3	31	4	4	4	25	26	4	4	25
3	2	2	2	3	26	4	4	28	2	2	31	4	4	28	2	2	31	4	4	4	4	25	3	2	31	4	4	4	25	26	4	4	4	25	3	2	2	26	4	4	4	4	4	4	4	25	26	4	4	4	4	4	4	25	26	4	4	4	25	26	4	4	25
3	27	27	27	27	30	4	4	25	3	27	30	4	4	29	27	3	26	4	4	4	4	29	27	27	30	4	4	4	25	26	4	4	4	25	3	27	27	30	4	4	4	28	2	2	2	3	3	2	2	2	31	4	4	25	26	4	4	4	25	26	4	4	25
26	4	4	4	4	4	4	4	25	26	47	4	4	4	4	48	25	26	4	4	4	4	4	4	38	38	4	4	4	25	26	4	4	4	25	26	4	4	4	4	4	4	25	3	27	27	27	3	3	27	3	26	4	4	29	26	4	4	4	25	26	4	4	25
26	4	4	4	4	4	4	4	25	26	47	4	4	4	4	48	25	26	4	4	4	4	4	4	4	4	4	4	4	25	26	37	37	37	25	26	4	4	4	4	4	4	25	26	4	4	4	25	26	4	25	26	4	4	4	29	31	4	4	25	26	4	4	25
26	4	4	28	2	2	2	2	3	3	2	2	2	2	2	2	3	3	2	2	2	31	4	4	4	4	4	4	4	25	3	2	2	2	3	26	4	4	28	31	4	4	25	26	4	4	4	25	26	4	29	30	4	4	4	4	25	31	4	25	26	4	4	25
26	4	4	25	3	27	27	27	3	3	27	27	27	27	27	27	27	27	27	27	3	26	4	4	37	37	4	4	4	29	27	27	27	3	3	26	4	4	29	26	37	37	25	26	4	4	4	25	26	4	4	4	4	4	4	4	25	26	4	25	26	4	4	25
26	4	4	25	26	4	4	4	25	26	4	4	4	4	4	4	4	4	4	4	25	26	4	4	28	31	4	4	4	4	4	4	4	29	3	26	4	4	4	3	2	2	3	26	4	4	4	25	30	4	4	4	4	4	4	4	25	26	4	25	26	4	4	25
26	4	4	25	26	4	4	4	25	26	4	4	4	4	4	4	4	4	4	4	25	26	4	4	29	30	4	4	4	4	4	4	4	4	25	26	4	4	4	3	27	27	3	26	4	4	28	26	4	4	4	4	4	4	4	4	25	26	4	25	26	4	4	25
26	4	4	25	26	4	4	4	29	30	4	4	4	4	4	4	4	4	4	4	25	26	4	4	4	4	4	4	4	4	4	4	4	4	25	26	4	4	28	26	4	4	25	26	4	4	25	26	4	4	4	4	4	4	28	2	3	26	4	25	26	4	4	25
26	4	4	25	26	4	4	4	4	4	4	4	28	2	2	31	4	4	28	2	3	3	2	2	2	2	2	2	31	4	4	4	4	4	25	26	4	4	25	26	4	4	25	26	4	4	25	26	4	4	4	4	4	4	25	3	27	30	4	25	26	4	4	25
26	4	4	29	30	4	4	4	4	4	4	4	25	3	27	30	4	4	29	27	27	27	27	27	27	27	27	3	26	4	4	4	4	4	25	30	4	4	25	26	4	4	25	26	4	4	25	26	4	4	4	4	4	4	25	26	4	4	4	25	26	4	4	25
26	4	4	4	4	4	4	4	4	4	4	4	25	26	4	4	4	4	4	4	4	4	4	4	4	4	4	25	26	4	4	28	2	2	3	4	4	4	25	26	4	4	25	26	4	4	25	3	2	2	2	2	31	4	25	26	4	4	4	4	26	4	4	25
26	4	4	4	4	4	4	4	4	4	4	4	25	26	4	4	4	4	4	4	4	4	4	4	4	4	4	25	26	4	4	29	27	27	3	4	4	4	25	26	4	4	25	26	4	4	25	3	27	27	3	3	30	4	25	26	4	4	4	25	26	4	4	25
26	4	4	28	2	2	2	2	2	31	4	4	25	3	2	2	2	2	2	2	2	31	4	28	31	4	4	25	26	4	4	4	4	4	25	31	4	4	25	26	4	4	25	26	4	4	25	26	4	4	25	26	4	4	25	26	4	4	4	4	26	4	4	25
26	4	4	25	3	27	27	27	27	30	4	4	25	3	27	27	27	27	27	27	3	26	4	25	26	4	4	25	26	4	4	4	4	4	25	26	4	4	25	26	4	4	25	26	4	4	25	26	4	4	25	26	4	4	25	26	4	4	4	25	26	4	4	25
26	4	4	25	26	4	4	4	4	4	4	4	25	26	4	4	4	4	4	48	25	26	4	25	26	4	4	25	26	4	28	2	2	2	3	26	4	4	25	26	4	4	25	26	4	4	29	30	4	4	25	26	4	4	4	4	4	4	4	25	26	4	4	25
26	4	4	25	26	4	4	4	4	4	4	4	25	26	4	4	4	4	4	48	25	26	4	25	26	37	37	25	26	4	25	3	27	27	27	30	4	4	25	26	4	4	25	26	4	4	4	4	4	4	25	3	2	31	4	4	4	4	4	25	26	4	4	25
26	37	37	25	26	4	4	4	28	2	2	2	3	26	4	4	28	2	2	2	27	30	4	25	3	2	2	3	26	4	25	26	4	4	4	4	4	4	25	26	4	4	25	26	4	4	4	4	4	4	29	27	27	3	31	4	4	4	4	25	26	4	4	25
3	2	2	3	26	4	4	4	29	27	27	27	27	30	4	4	25	3	27	30	4	4	4	25	3	27	27	27	30	4	25	26	4	4	4	4	4	4	29	30	4	4	29	30	4	4	28	31	4	4	4	4	4	29	3	31	4	4	4	25	26	4	4	25
3	27	27	3	26	4	4	4	4	4	4	4	4	4	4	4	25	26	4	4	4	4	4	25	26	47	4	4	4	4	25	3	2	31	4	4	4	4	4	4	4	4	4	4	4	4	25	26	4	4	4	4	4	4	29	3	31	4	4	25	26	4	4	25
26	4	4	25	26	4	4	4	4	4	4	4	4	4	4	4	25	26	37	37	37	37	37	25	26	47	4	4	4	4	25	3	27	30	4	4	4	4	4	4	4	4	4	4	4	4	25	3	2	2	4	4	4	4	4	25	26	4	4	25	26	4	4	25
26	4	4	25	3	2	2	2	31	4	4	28	2	2	2	2	3	3	2	2	2	2	2	3	3	2	31	4	4	4	25	26	4	4	4	4	4	4	4	4	4	4	4	4	4	4	29	27	3	26	4	4	4	4	4	25	26	4	4	29	30	4	4	25
26	4	4	29	27	27	27	3	26	4	4	29	27	27	27	3	3	27	27	3	3	27	27	27	27	27	30	4	4	4	25	26	4	4	4	4	4	4	4	4	4	4	4	4	4	4	4	4	25	3	2	31	4	4	4	25	26	4	4	4	4	4	4	25
26	4	4	4	4	4	4	25	26	4	4	4	4	4	4	25	26	4	4	25	26	4	4	4	4	4	4	4	28	2	3	26	4	4	4	4	4	4	28	2	31	4	4	4	4	4	4	4	29	27	27	3	2	2	2	3	26	4	4	4	4	4	4	25
26	4	4	4	4	4	4	29	30	4	4	4	4	4	4	25	26	4	4	29	30	4	4	4	4	4	4	4	29	27	27	30	4	4	4	4	4	4	29	3	26	4	4	28	31	4	4	4	4	4	4	29	27	27	27	3	26	4	4	28	31	4	4	25
26	4	4	28	31	4	4	4	4	4	4	28	31	4	4	25	26	4	4	4	4	4	4	28	31	4	4	4	4	4	4	4	4	4	28	31	4	4	4	25	26	4	4	25	26	4	4	4	4	4	4	4	4	4	4	25	26	4	4	25	26	4	4	25
26	4	4	25	26	45	45	4	4	4	4	25	26	45	45	25	26	4	4	4	4	4	4	25	26	4	4	4	4	4	4	4	4	4	25	26	37	37	4	25	26	37	37	25	26	4	4	4	4	4	4	4	4	4	4	25	26	37	37	25	26	4	4	25
26	4	4	25	3	2	2	2	2	2	2	3	3	2	2	3	3	2	2	2	2	2	2	3	3	2	2	2	2	2	2	2	2	2	3	3	2	2	2	3	3	2	2	3	3	2	2	2	2	2	2	2	2	2	2	3	3	2	2	3	26	4	4	25
26	4	4	29	27	27	27	27	27	27	27	27	27	27	27	27	27	27	27	27	27	27	27	27	27	27	27	27	27	27	27	27	27	27	27	27	27	27	27	27	27	27	27	27	27	27	27	27	27	27	27	27	27	27	27	27	27	27	27	27	30	4	4	25
4	4	4	4	4	4	4	4	4	4	4	4	4	4	4	4	4	4	4	4	4	4	4	4	4	4	4	4	4	4	4	4	4	4	4	4	4	4	4	4	4	4	4	4	4	4	4	4	4	4	4	4	4	4	4	4	4	4	4	4	4	4	4	25
2	2	2	2	2	2	2	2	2	2	2	2	2	2	2	2	2	2	2	2	2	2	2	2	2	2	2	2	2	2	2	2	2	2	2	2	2	2	2	2	2	2	2	2	2	2	2	2	2	2	2	2	2	2	2	2	2	2	2	2	2	2	2	3
7 2742 0 1 2806 0 1 2464 2 0 2528 2 0 1619 0 1 1133 0 1 300 0 1
50 2788 2 2789 2 2793 2 2794 2 2809 2 2810 2 2386 2 2387 2 2388 2 2389 2 2390 2 2177 2 2178 2 2137 2 2138 2 1448 2 1449 2 1432 2 1433 2 1240 3 1241 3 1311 2 1312 2 1313 2 1060 2 1061 2 881 3 882 3 883 3 624 1 688 1 425 2 426 2 427 2 428 2 536 2 537 2 538 2 784 2 785 2 588 2 589 2 332 3 333 3 321 3 322 3 323 3 1025 2 1026 2 1027 2
1 4960 80 map/ArenaBoss.map 0 1 1 1
18 2757 0 2758 0 2765 0 2766 0 2329 2 2393 2 2131 3 2067 3 1226 2 1290 2 1231 3 1295 3 984 2 1048 2 728 2 792 2 532 0 533 0
158 2573 0 2574 0 2245 0 2246 0 2181 0 2182 0 2049 0 2050 0 2577 0 2578 0 2641 0 2642 0 2779 0 2781 0 2783 0 2065 0 2129 0 1809 0 1877 0 2009 0 2010 0 1549 0 1551 0 1553 0 1623 0 1625 0 1627 0 1827 0 1510 0 2340 0 2407 0 2726 0 2790 0 1305 0 1369 0 1985 2 1986 2 1478 2 1479 2 1542 1 1543 1 1874 1 1814 1 2260 2 2324 2 2323 2 2331 2 2395 2 2583 1 2648 1 2403 2 2404 1 1761 2 1696 2 1228 2 1292 2 1229 1 1293 1 1032 0 971 0 1037 0 975 0 1172 0 1171 2 1108 1 779 0 780 0 781 0 66 0 131 0 82 0 147 0 405 0 404 0 90 0 155 0 408 0 409 0 410 0 731 0 795 0 987 0 1051 0 608 0 672 1 673 2 99 0 100 0 101 0 932 0 933 0 1056 2 1057 2 1120 2 1121 2 297 1 298 2 109 0 110 2 111 1 173 0 174 0 175 2 436 0 437 0 617 0 681 1 682 1 680 0 745 0 621 2 622 0 685 2 686 0 760 0 761 0 824 0 825 0 945 0 948 0 1137 0 1329 0 1461 0 1586 0 1717 0 1712 0 1193 0 1257 0 1256 0 1388 2 1389 0 1390 0 1452 2 1453 1 1454 1 2346 0 2347 0 2410 0 2411 0 2036 0 2037 0 2422 0 2421 1 2485 0 2484 1 2549 1 2550 0 2553 0 2554 0 2617 0 2618 0 2797 0 2799 0 2801 0 2803 0 2736 0 2665 1 2666 1 
0
16 2370 1 1 2 2369 1 1 2 2769 2 0 0 2785 3 0 1 2208 2 0 0 2272 2 0 0 2040 2 0 0 1912 2 0 0 1784 2 0 0 1851 3 0 1 1979 3 0 1 1672 1 1 2 422 1 1 2 1064 1 1 2 116 3 0 1 180 3 0 1
26 2382 0 2383 0 2121 0 2122 0 1669 1 1734 1 1485 2 1489 2 2016 0 1566 1 1567 1 1568 1 1299 0 1039 0 1033 0 2604 0 2536 0 2412 1 2408 1 2405 1 1779 0 1777 0 1649 1 1651 1 1522 1 1588 1
16 1217 2 1218 2 1870 0 1640 2 1641 2 1252 2 1253 2 1968 2 1969 2 724 2 725 2 1141 2 119 2 382 2 1324 2 1325 2
0
1 4020 1370
1 1040 600
0
none
10000 10000 1 1
80 3700