map/Vocalno.map
8	8	8	8	8	8	8	8	8	8	8	8	8	8	8	8	8	8	8	8	8	8	8	8	8	8	8	8	8	8	8	8	8	8	8	8	8	8	8	8	8	8	8	8	8	8	8	8	8	8	8	8	8	8	8	8	8	8	8	8	8	8	8	8
8	14	14	14	14	8	14	14	14	14	14	14	14	14	8	14	14	14	8	14	14	53	53	53	53	53	53	53	53	53	53	53	53	8	8	8	8	8	14	14	14	14	14	14	14	14	14	14	14	14	14	14	14	14	14	14	14	14	14	14	14	14	14	14
8	14	14	14	14	8	14	14	14	14	14	14	14	14	8	14	14	14	8	14	14	14	14	14	14	14	14	14	14	14	14	14	14	14	8	8	8	8	14	14	14	14	14	14	14	14	14	14	14	14	14	14	14	14	14	14	14	14	14	14	14	14	14	14
8	14	14	14	14	14	14	14	14	14	14	14	14	14	14	14	14	8	8	14	14	14	14	14	14	14	14	14	14	14	14	14	14	14	14	8	8	8	14	14	14	14	14	14	14	14	14	14	14	14	14	14	14	14	14	14	14	14	14	14	14	14	14	14
8	14	14	14	14	14	8	14	14	14	8	14	14	8	8	8	14	14	8	14	14	52	14	14	14	14	8	8	8	8	14	14	14	14	14	14	8	8	14	14	14	14	14	14	14	14	14	14	14	14	14	14	14	14	14	14	14	14	14	14	14	14	14	14
8	14	14	14	14	8	8	14	14	8	8	14	14	8	14	8	14	14	8	14	14	8	14	14	14	14	8	8	8	8	8	14	14	14	14	14	14	14	14	14	14	14	14	14	14	14	14	14	14	14	14	14	14	14	14	14	14	14	14	14	14	14	14	14
8	14	14	14	14	14	8	14	14	14	8	14	14	8	8	8	14	14	8	14	14	8	14	14	14	8	8	8	14	14	8	8	14	14	14	14	14	14	14	14	14	14	14	14	14	14	14	14	14	14	14	14	14	14	14	14	14	14	14	14	14	14	14	14
8	8	8	14	14	8	8	8	14	8	8	8	14	14	14	8	14	8	8	14	14	8	14	14	14	8	8	14	14	14	14	14	14	14	14	14	8	8	14	14	14	14	14	14	14	14	14	14	14	14	14	14	14	14	14	14	14	14	14	14	14	14	14	14
8	14	14	14	14	14	14	14	14	14	14	14	14	14	14	14	14	14	8	14	14	8	14	14	8	8	8	14	14	14	14	14	14	14	14	8	8	8	14	14	14	14	14	14	14	14	14	14	14	14	14	14	14	14	14	14	14	14	14	14	14	14	14	14
8	14	14	14	14	8	14	14	14	14	14	14	14	14	8	14	14	14	8	14	14	8	14	14	8	8	14	14	14	14	8	8	8	8	8	8	8	8	14	14	14	14	14	14	14	14	14	14	14	14	14	14	14	14	14	14	14	14	14	14	14	14	14	14
8	14	8	8	8	8	8	8	8	8	8	8	8	8	8	8	8	8	8	14	14	8	14	14	8	8	14	14	14	14	14	8	8	8	8	8	8	8	8	8	8	8	8	8	8	8	8	8	8	8	8	8	8	8	8	8	8	8	8	8	8	8	8	8
8	14	14	14	14	14	14	14	14	14	14	14	14	14	14	14	14	14	14	14	14	8	14	14	8	8	8	14	14	14	14	14	14	14	14	14	14	8	8	8	8	8	8	8	8	8	8	8	8	8	8	8	8	8	8	8	8	8	8	8	8	8	8	8
8	8	8	8	14	14	14	14	14	14	14	14	14	14	14	14	14	14	14	14	14	8	14	14	14	8	8	8	14	14	14	14	14	14	14	14	14	8	8	8	8	8	8	8	8	8	14	14	14	14	14	14	14	14	8	8	8	8	8	14	14	14	14	14
8	8	8	8	8	8	8	8	8	8	8	8	8	8	8	8	8	8	8	8	8	8	14	14	14	14	8	8	8	8	8	8	8	8	8	8	8	8	8	8	8	8	8	14	14	14	14	14	14	14	14	14	14	14	14	14	14	14	14	14	14	14	14	14
8	8	8	8	8	8	8	8	8	8	8	8	8	8	8	8	8	8	8	8	8	8	14	14	14	14	14	8	8	8	8	8	8	8	8	8	8	8	8	14	14	14	14	14	14	14	14	14	14	14	14	14	14	14	14	14	14	14	14	14	14	14	14	14
8	8	8	53	53	53	53	53	53	53	53	53	53	53	53	53	53	53	53	53	53	53	14	14	14	14	14	14	14	14	14	14	14	14	14	14	14	14	14	14	14	14	14	14	14	14	8	8	8	8	8	8	8	14	14	14	8	8	8	8	8	8	8	8
8	14	14	14	14	14	14	14	14	14	14	14	14	14	14	14	14	14	14	14	14	14	14	14	14	14	14	14	14	14	14	14	14	14	14	14	14	14	14	14	14	14	14	8	8	8	8	8	8	8	8	8	8	8	14	14	14	8	8	8	8	8	8	8
14	14	14	14	14	14	14	14	14	14	14	14	14	14	14	14	14	14	14	14	14	14	14	8	8	14	14	14	14	14	14	14	14	14	14	14	14	14	14	14	14	8	8	8	8	8	8	8	8	8	8	8	8	8	8	14	14	14	8	8	14	14	14	14
14	14	14	14	14	8	14	8	8	14	14	14	14	14	14	14	14	14	14	14	14	8	8	8	8	8	8	8	8	8	8	8	14	14	14	14	14	8	8	8	8	8	8	8	8	8	8	14	14	14	14	8	8	8	8	8	14	14	14	14	14	14	14	14
8	8	8	14	14	8	8	8	8	8	8	14	14	14	14	14	14	14	14	14	8	8	8	8	8	8	8	8	8	8	8	8	8	8	8	8	8	8	8	8	8	8	8	8	8	8	14	14	14	14	14	14	8	8	8	8	14	14	14	14	14	14	14	14
8	8	8	14	14	8	8	8	8	8	8	8	8	8	52	52	52	52	52	52	8	8	8	8	8	8	8	8	8	8	8	8	8	8	8	8	8	8	8	8	8	8	8	8	8	14	14	14	14	14	14	14	14	8	8	8	8	14	14	14	14	14	14	14
8	8	8	14	14	8	8	8	8	8	8	8	8	8	8	8	8	8	8	8	8	8	14	14	14	14	8	8	8	8	8	8	8	8	8	8	8	8	8	8	8	8	8	8	14	14	14	8	8	10	10	10	10	10	8	8	8	8	14	14	14	14	14	14
8	8	8	14	14	8	8	8	8	8	8	8	8	8	8	8	8	8	8	8	8	14	14	14	14	14	14	14	14	14	14	14	14	14	8	8	8	8	8	8	8	8	14	14	14	14	14	8	8	10	10	10	10	10	10	8	8	8	14	14	14	14	14	14
8	8	8	14	14	8	8	8	8	14	8	8	14	8	8	8	8	8	8	14	14	14	14	14	14	14	14	14	14	14	14	14	14	14	8	8	14	14	14	14	14	14	14	14	14	14	14	8	8	10	10	10	10	10	10	10	8	8	8	14	14	14	14	14
14	14	14	14	14	14	14	14	14	14	53	53	14	14	14	14	14	8	8	14	14	14	14	14	14	14	14	14	14	14	14	14	14	14	8	8	14	14	14	14	14	14	14	14	14	14	8	8	8	8	10	10	10	10	10	10	10	8	8	8	14	14	14	14
14	14	14	14	14	14	14	14	14	14	14	14	14	14	14	14	73	8	8	14	14	14	14	14	14	14	14	14	14	52	52	14	14	14	53	53	14	14	14	14	14	14	14	8	8	8	8	14	14	8	8	10	10	10	10	10	10	10	8	8	8	8	8	8
14	14	14	14	14	14	14	14	14	14	14	14	14	14	14	14	14	53	53	14	14	14	14	14	14	14	14	14	14	8	8	14	14	14	14	14	14	14	14	14	14	14	14	14	14	14	14	14	14	14	8	8	10	10	10	10	10	10	10	8	8	8	8	8
8	8	14	14	14	14	14	14	14	14	14	14	14	14	14	14	14	14	14	14	14	14	14	14	14	14	14	14	14	8	8	14	14	14	14	14	14	14	14	52	52	14	14	14	14	14	14	14	14	14	14	8	8	10	10	10	10	10	10	10	8	8	8	8
8	8	8	14	14	14	14	14	14	14	14	14	14	14	14	14	14	14	14	14	14	14	14	14	14	14	8	8	8	7	7	8	8	8	8	8	8	14	14	8	8	14	14	14	14	14	14	14	14	14	14	8	8	8	10	10	10	10	10	10	10	8	8	8
8	8	8	8	8	8	8	14	14	14	8	8	14	14	14	14	14	52	52	14	14	14	14	14	8	8	8	8	8	7	8	10	8	8	8	8	8	8	8	8	8	14	14	14	14	8	8	8	8	8	8	8	8	8	8	10	10	10	10	10	10	10	8	8
8	8	8	8	8	8	8	14	14	14	8	8	14	14	14	14	14	8	8	14	14	14	8	8	8	8	8	8	8	8	10	10	10	8	8	8	8	8	8	8	8	8	8	8	8	8	8	8	8	8	8	8	8	8	8	8	8	10	10	10	10	10	10	8
8	8	8	8	10	8	8	8	8	8	8	8	14	14	14	14	14	8	8	14	14	8	8	8	8	8	8	8	8	10	10	10	10	10	8	8	8	8	8	8	8	8	8	8	8	10	10	8	8	8	10	10	8	8	8	8	8	8	10	10	10	10	10	8
8	8	8	10	10	10	8	8	8	8	8	8	8	8	8	8	8	8	8	8	8	8	8	8	8	7	8	8	10	10	10	10	10	10	10	8	8	8	8	8	8	8	8	8	10	10	10	10	8	10	10	10	10	8	8	8	8	8	10	10	10	10	10	8
8	8	10	10	10	10	10	8	8	8	8	8	8	8	8	8	8	8	8	8	8	8	8	8	8	8	8	10	10	10	10	10	10	10	10	10	8	8	8	8	8	8	8	10	10	10	10	10	10	10	10	10	10	10	8	8	8	10	10	10	10	10	8	10
8	10	10	10	10	10	10	10	8	8	8	8	8	8	8	8	8	8	8	10	10	8	8	8	8	8	10	10	10	10	10	8	10	10	10	10	10	8	8	8	8	8	10	10	10	10	10	10	10	10	10	10	10	10	10	8	10	10	10	10	10	8	10	10
10	10	10	10	10	10	10	10	10	8	8	8	8	8	8	8	8	8	10	10	10	10	8	8	8	10	10	10	10	10	8	10	8	10	10	10	10	10	8	8	8	10	10	10	10	10	10	10	10	10	10	10	10	10	10	10	10	10	10	10	8	10	10	10
10	10	10	10	8	10	10	10	10	10	8	8	8	8	8	8	8	10	10	10	10	10	10	8	10	10	10	10	10	8	10	10	10	8	10	10	10	10	10	8	10	10	10	10	10	8	10	10	10	10	10	8	10	10	10	10	10	10	10	8	10	10	10	10
10	10	10	8	14	8	10	10	10	10	10	8	8	8	8	8	10	10	10	10	10	10	10	10	10	10	10	10	8	10	10	10	10	10	8	10	10	10	10	10	10	10	10	10	8	10	8	10	10	10	8	10	8	10	10	10	10	10	8	10	10	10	10	10
10	10	8	14	14	14	8	10	10	10	10	10	8	8	8	10	10	10	10	10	10	10	10	10	10	10	10	8	10	10	10	10	10	10	10	8	10	10	10	10	10	10	10	8	10	10	10	8	10	8	10	10	10	8	10	10	10	8	10	10	10	10	10	10
10	8	14	14	14	14	8	10	10	10	10	10	10	8	10	10	10	10	10	10	8	10	10	10	10	10	8	10	10	10	10	10	10	10	10	10	8	10	10	10	10	10	8	10	10	10	10	10	8	10	10	10	10	10	8	10	8	10	10	10	10	10	10	8
8	14	14	14	14	8	10	10	10	10	10	10	10	10	10	10	10	10	10	8	10	8	10	10	10	8	10	10	10	10	10	8	10	10	10	10	10	8	10	10	10	8	10	10	10	10	10	10	10	10	10	10	10	10	10	8	10	10	10	10	10	10	8	8
14	14	14	14	14	14	8	10	10	10	10	10	10	10	10	10	10	10	8	10	10	10	8	10	8	10	10	10	10	10	8	8	8	10	10	10	10	10	8	10	8	10	10	10	10	10	10	10	10	10	10	10	10	10	10	10	10	10	10	10	10	8	8	8
8	8	10	10	10	10	10	8	10	10	10	10	10	10	10	10	10	8	10	10	10	10	10	8	10	10	10	10	10	8	8	8	8	8	10	10	10	10	10	8	10	10	10	10	10	10	10	10	10	10	10	10	10	10	10	10	10	10	10	10	8	8	8	8
8	8	8	10	10	10	10	10	8	10	10	10	10	10	10	10	8	10	10	10	10	10	10	10	10	10	10	10	8	8	8	8	8	8	8	10	10	10	10	10	10	10	10	10	10	8	10	10	10	10	10	8	10	10	10	10	10	10	10	8	8	8	8	8
8	8	8	8	10	10	10	10	10	8	10	10	10	10	10	8	10	10	10	10	10	10	10	10	10	10	10	8	8	8	8	8	8	8	8	8	10	10	10	10	10	10	10	10	8	8	8	10	10	10	8	8	8	10	10	10	10	10	8	8	8	8	8	8
8	8	8	8	8	10	10	10	10	10	8	10	10	10	8	10	10	10	10	10	8	10	10	10	10	10	8	8	8	8	8	8	8	8	8	8	8	10	10	10	10	10	10	8	8	8	8	8	10	8	8	8	8	8	10	10	10	8	8	8	8	8	8	8
8	8	8	8	8	8	10	10	10	10	10	8	10	8	10	10	10	10	10	8	8	8	10	10	10	8	8	8	8	8	8	8	8	8	8	8	8	8	10	10	10	10	8	8	8	8	8	8	8	8	8	8	8	8	8	10	8	8	8	8	8	8	8	8
8	8	8	8	8	8	8	10	10	10	10	10	8	10	10	10	10	10	8	8	8	8	8	10	8	8	8	8	8	8	8	8	8	8	8	8	8	8	8	8	8	8	8	8	8	8	8	8	8	8	8	8	8	8	8	8	8	8	8	8	8	8	8	8
0
0
1 4640 560 map/FinalMap.map 0 1 1
2 602 2 666 2
206 71 2 72 2 73 1 74 1 75 1 157 2 158 2 159 2 194 2 223 2 224 2 257 2 259 2 289 2 322 2 353 2 417 2 477 1 478 2 479 2 480 2 481 2 529 2 540 1 541 1 592 2 593 2 604 1 668 1 669 1 711 1 712 2 714 1 716 1 718 2 719 2 733 1 734 1 735 1 774 1 775 2 777 1 781 1 783 2 784 2 797 0 798 0 799 0 894 1 958 0 1055 0 1056 0 1088 1 1089 1 1103 0 1104 0 1105 0 1119 1 1120 1 1152 0 1153 0 1167 0 1168 0 1169 0 1278 1 1279 1 1341 0 1395 0 1406 0 1407 0 1460 0 1470 0 1471 0 1508 0 1509 0 1524 0 1525 0 1572 0 1573 0 1589 0 1653 0 1654 0 1668 1 1669 1 1686 0 1687 0 1713 0 1718 0 1719 0 1742 0 1750 0 1751 0 1762 1 1763 1 1776 0 1777 0 1778 0 1783 0 1784 0 1805 0 1806 0 1807 0 1840 0 1842 0 1849 0 1850 0 1870 0 1914 0 1927 0 1928 0 1929 0 1979 0 2003 1 2004 1 2015 0 2078 0 2141 0 2157 0 2158 0 2161 0 2162 0 2204 0 2220 0 2221 0 2222 0 2224 0 2225 0 2226 0 2227 0 2228 0 2267 0 2283 0 2284 0 2287 0 2288 0 2292 0 2293 0 2330 0 2393 0 2430 0 2456 0 2462 0 2492 0 2505 0 2512 0 2525 0 2541 0 2547 0 2556 0 2569 0 2576 0 2588 0 2604 0 2605 0 2606 0 2610 0 2611 0 2612 0 2619 0 2633 0 2635 0 2638 0 2640 0 2651 0 2668 0 2670 0 2671 0 2673 0 2674 0 2676 0 2681 0 2692 0 2699 0 2702 0 2708 0 2714 0 2735 0 2736 0 2737 0 2757 0 2763 0 2766 0 2771 0 2772 0 2773 0 2777 0 2778 0 2800 0 2808 0 2822 0 2834 0 2835 0 2837 0 2838 0 2840 0 2841 0 2887 0 2897 0 2898 0 2902 0 2903 0 2904 0 2952 0 2960 0 2961 0 2967 0 
0
12 740 3 0 1 804 3 0 1 815 1 1 2 816 1 1 2 817 1 1 2 818 1 1 2 819 1 1 2 820 1 1 2 827 1 1 2 828 1 1 2 1210 1 1 2 1211 1 1 2
67 129 1 136 2 137 2 138 2 139 2 140 2 195 1 258 1 327 1 332 1 401 1 528 1 584 0 585 0 586 0 587 0 993 1 1003 0 1005 0 1058 1 1059 1 1101 2 1104 2 1105 2 1106 2 1114 0 1116 0 1121 1 1123 1 1126 0 1127 0 1165 2 1166 2 1167 2 1170 2 1342 1 1343 1 1494 2 1497 2 1498 2 1558 1 1561 2 1574 2 1575 2 1620 1 1621 1 1624 2 1625 2 1684 1 1685 1 1708 2 1711 1 1712 2 1754 0 1759 0 1760 0 1771 1 1773 2 1795 0 1796 0 1797 0 1816 0 1839 0 1841 0 1878 0 1596 0 1599 0
5 1544 2 1481 2 1549 2 1550 2 1551 2 
4 560 3760 1 1200 3760 -90 1040 3760 1 -1 -1 0 5040 2720 2 0 2960 0 0 2800 2 -1 -1 0
1 2740 970
0
1 1360 200
lavaboss
3040 80 2080 720
80 3300