map/WarmUp.map
27	27	27	27	27	27	27	27	27	27	27	27	27	27	27	27	27	27	27	27	27	27	3	3	3	3	3	3	3	3	3	27	27	27	3	3	3	27	27	27	27	3	3	3	3	27	27	27	27	3	3	3	27	27	27	27	27	27	27	27	27	27	27	27
4	4	4	4	4	4	4	4	4	4	4	4	4	4	4	4	4	4	4	4	4	4	25	3	3	3	3	3	3	3	26	4	4	4	29	27	30	4	4	4	4	29	27	27	30	4	4	4	4	29	3	3	4	4	4	4	4	4	4	4	4	4	4	4
4	4	4	4	4	4	4	4	4	4	4	4	4	4	4	4	4	4	4	4	4	4	29	3	3	3	3	3	3	3	30	4	4	4	38	38	38	4	4	4	4	4	38	38	4	4	4	4	4	4	29	27	4	4	4	4	4	4	4	4	4	2	2	2
2	2	2	31	4	4	4	4	4	4	4	28	2	2	31	4	4	4	4	4	4	4	4	29	3	3	3	3	3	30	4	4	4	4	4	4	4	4	4	4	4	4	4	4	4	4	4	4	4	4	4	55	4	4	4	4	2	2	2	4	4	4	4	4
3	27	27	30	4	4	4	4	4	4	4	29	27	27	30	4	4	4	4	4	4	4	4	4	29	3	3	3	30	4	4	4	4	4	4	4	4	4	4	4	4	4	4	4	4	4	4	4	4	4	4	57	4	2	2	4	4	4	4	4	4	4	4	4
26	4	4	4	4	4	4	4	4	4	4	4	4	4	4	4	4	4	4	4	4	4	4	4	4	29	27	30	4	4	4	4	4	4	37	37	37	4	4	4	4	4	37	37	4	4	4	4	4	4	28	2	4	4	4	4	4	4	4	4	4	4	4	4
26	4	4	4	4	4	4	4	4	4	4	4	4	4	4	4	4	4	4	4	4	4	4	4	4	4	4	4	4	4	4	4	4	4	28	2	31	4	4	4	4	28	2	2	31	4	4	4	4	28	3	3	4	4	4	4	4	4	4	4	4	4	4	4
26	4	4	4	4	4	4	4	28	31	37	37	37	37	37	37	37	37	37	37	28	31	4	4	4	4	4	4	4	4	4	4	28	2	3	3	3	2	2	2	2	3	3	3	2	2	2	2	3	3	3	3	2	2	2	2	2	2	2	2	2	2	2	2
3	2	2	2	2	31	4	4	25	3	2	2	2	2	2	2	2	2	2	2	3	26	4	4	4	4	4	4	4	4	4	28	3	3	3	3	3	3	3	3	3	3	3	3	3	3	3	3	3	3	3	3	3	3	3	3	3	3	3	3	3	3	3	3
27	27	27	27	27	30	4	4	29	3	3	3	3	3	3	3	3	3	3	3	3	30	4	4	4	4	4	4	4	4	28	3	3	3	27	27	27	27	27	27	27	27	27	27	27	27	27	27	27	27	27	27	27	27	27	27	27	27	27	27	27	27	27	27
4	4	4	4	4	4	4	4	4	29	27	27	27	27	27	27	27	27	27	27	27	4	4	4	4	4	4	4	4	28	3	3	3	30	4	4	4	4	4	4	4	4	4	4	4	4	4	4	4	4	4	4	4	4	4	4	4	4	4	4	4	4	4	4
4	4	4	4	4	4	4	4	4	4	4	4	4	4	4	4	4	4	4	4	4	4	4	4	28	31	4	4	28	3	3	3	30	4	4	4	4	4	4	4	4	4	4	4	4	4	4	4	4	4	4	4	4	4	4	4	4	4	4	4	4	4	4	4
2	2	2	2	2	2	2	2	4	4	4	4	4	4	4	4	4	4	4	4	4	4	4	28	3	26	60	62	25	3	3	30	4	4	4	4	28	2	2	2	2	2	2	2	31	4	4	4	4	28	2	2	2	2	2	31	4	4	4	4	4	4	4	4
3	3	3	3	3	3	3	3	2	2	2	2	2	2	2	2	2	2	2	2	2	2	2	3	3	26	4	4	29	27	30	4	4	4	4	28	3	3	3	3	3	3	3	3	3	31	4	4	28	3	27	27	27	27	27	3	2	4	4	4	4	4	28	2
3	3	3	3	3	3	3	3	3	3	3	27	27	27	27	27	27	27	27	27	3	3	3	3	3	26	4	4	4	4	4	4	4	4	28	3	3	3	3	3	3	3	3	3	3	3	2	2	3	30	4	4	4	4	4	29	27	30	4	4	4	4	25	3
27	27	27	27	27	27	3	3	3	3	30	4	4	4	4	4	4	4	4	4	29	3	3	3	3	26	4	4	4	4	4	4	4	28	3	27	27	27	27	27	27	27	27	27	3	3	3	3	30	4	4	4	4	4	4	4	4	4	4	4	28	2	3	3
4	4	4	4	4	4	29	3	3	30	4	4	4	4	4	4	4	4	4	4	4	29	27	27	27	30	4	4	4	4	4	4	28	3	30	4	4	4	4	4	4	4	4	4	29	3	3	26	4	4	4	4	4	4	4	4	4	4	4	4	25	3	3	3
4	4	4	4	4	4	4	29	30	4	4	4	4	4	4	4	4	4	4	4	4	4	4	4	4	4	4	4	4	4	4	28	3	30	4	4	4	4	4	4	4	4	4	4	4	29	3	3	31	4	4	4	4	4	4	28	31	4	4	4	29	3	3	3
37	37	4	4	4	4	4	4	4	4	4	4	4	4	4	4	4	4	4	4	4	4	4	4	4	4	4	4	4	4	28	3	26	4	4	4	4	28	2	2	2	31	4	4	4	4	29	3	3	2	2	2	2	2	2	3	30	4	4	4	4	29	3	3
2	31	4	4	4	4	4	4	4	4	4	4	28	2	2	2	2	2	2	2	2	2	31	4	4	4	4	4	4	28	3	3	26	4	4	4	4	25	3	3	3	3	31	4	4	4	4	29	27	27	27	27	27	27	27	30	4	4	4	4	4	4	29	27
3	26	4	4	4	4	4	4	4	4	4	28	3	3	3	3	3	3	3	3	3	3	3	31	4	4	4	4	28	3	3	3	26	4	4	4	4	25	3	3	3	3	3	31	4	4	4	4	4	4	4	4	4	4	4	4	4	4	4	4	4	4	4	4
3	26	4	4	4	4	4	4	4	4	28	3	3	3	3	3	3	3	3	3	3	3	3	3	2	2	2	2	3	3	3	3	26	4	4	4	4	29	3	3	3	3	3	3	31	4	4	4	4	4	4	4	4	4	4	4	4	4	4	4	4	4	4	4
3	3	2	31	4	4	28	2	2	3	3	3	3	3	3	3	3	3	3	3	3	3	3	3	3	3	3	3	3	3	3	3	26	4	4	4	4	4	29	3	3	3	3	3	3	2	2	2	2	2	2	2	2	2	2	2	2	2	2	2	2	2	2	2
3	27	27	30	4	4	29	27	27	27	27	27	27	27	27	27	27	27	27	27	27	27	27	27	27	27	27	27	27	27	27	3	26	4	4	4	4	4	4	29	3	3	3	27	27	27	27	27	27	27	27	27	27	27	27	27	27	27	27	27	27	27	27	27
30	4	4	4	4	4	4	4	4	4	4	4	38	4	4	38	4	4	38	4	4	38	4	4	38	4	38	4	4	4	4	25	26	4	4	4	4	4	4	4	25	3	26	4	4	4	4	4	4	55	4	4	4	4	4	4	4	4	4	4	4	4	4	4
4	4	4	4	4	4	4	4	4	4	4	4	4	4	4	4	4	4	4	4	4	4	4	4	4	4	4	4	4	4	4	25	26	4	4	4	4	4	4	4	29	3	26	4	4	4	4	4	4	57	4	4	4	4	4	4	4	4	4	4	4	4	4	4
4	4	4	37	4	4	28	31	37	4	4	4	37	4	4	37	4	4	37	4	4	37	4	4	37	4	37	4	4	4	4	25	26	4	4	37	37	4	4	4	4	29	30	4	4	4	28	2	2	2	2	2	31	4	4	4	4	4	4	4	4	4	4	4
2	2	2	31	4	4	25	3	2	2	2	2	2	2	2	2	2	2	2	2	2	2	2	2	2	2	31	4	4	4	4	25	26	4	4	28	31	4	4	4	4	4	4	4	4	4	29	3	3	3	3	3	3	2	2	2	2	2	2	31	4	28	31	4
3	3	3	30	60	62	29	27	27	3	3	3	3	27	27	27	27	27	27	27	27	27	27	27	3	3	3	31	4	4	4	25	26	4	4	25	26	4	4	4	4	4	4	4	4	4	4	25	3	3	3	3	3	27	27	27	27	3	3	26	4	25	3	2
27	27	30	4	4	4	38	38	38	29	27	27	30	38	38	38	38	38	38	38	38	38	38	38	29	3	3	3	31	60	62	25	26	4	4	25	3	2	31	4	4	4	4	4	4	4	4	29	27	27	27	27	30	4	55	4	4	29	27	30	4	25	3	27
4	4	4	4	4	4	4	4	4	38	38	38	38	4	4	4	4	4	4	4	4	4	4	4	4	29	3	3	30	4	4	29	30	4	4	29	3	3	3	2	2	2	2	31	4	4	4	4	4	4	4	4	4	4	57	4	4	4	4	4	4	29	30	4
4	4	4	4	4	4	4	4	4	4	4	4	4	4	4	4	4	4	4	4	4	4	4	4	4	4	29	30	4	4	4	4	4	4	4	4	29	3	3	3	3	3	3	3	2	4	4	4	4	4	4	4	4	4	28	31	4	4	4	4	4	4	38	4
2	2	31	42	4	4	4	4	4	4	4	4	4	4	4	4	4	4	28	2	2	31	4	4	4	4	55	4	4	4	4	4	4	4	4	4	4	29	27	27	27	27	27	27	3	31	4	4	37	37	37	4	4	28	3	3	2	2	2	4	4	4	4	4
3	3	3	2	31	4	4	4	4	4	4	4	4	4	4	4	4	28	3	3	3	26	4	4	4	4	57	4	4	4	4	4	4	4	4	4	4	4	4	4	4	4	4	4	29	3	2	2	2	2	2	2	2	3	27	27	27	3	3	31	4	4	4	4
3	3	3	3	3	31	37	37	4	4	4	4	4	4	37	37	28	3	3	3	3	26	60	62	28	2	2	2	31	4	4	28	2	2	31	4	4	4	4	4	4	4	4	4	4	29	27	27	27	27	27	27	27	30	4	4	4	29	3	3	2	2	2	2
3	3	3	3	3	3	2	2	2	2	2	2	2	2	2	2	3	3	3	3	3	30	4	4	29	27	27	27	30	4	4	29	27	27	30	4	4	4	4	4	4	4	4	4	4	4	4	4	4	38	38	38	4	4	4	4	4	4	29	27	27	27	27	27
3	3	3	3	3	3	3	3	3	3	3	3	27	27	27	27	3	3	3	3	30	4	4	4	4	4	4	4	4	4	4	4	4	4	4	4	4	4	4	4	4	4	4	4	4	4	4	4	4	4	4	4	4	4	4	4	4	4	4	4	55	4	4	4
3	27	27	27	27	27	3	3	3	3	3	30	4	4	4	4	29	27	27	30	4	4	4	4	4	4	4	4	4	4	4	4	4	4	4	4	4	4	4	4	28	2	2	2	31	4	4	4	4	4	4	4	4	4	4	4	4	4	4	4	57	4	4	4
30	4	4	4	4	4	29	27	27	27	30	4	4	4	4	4	4	4	4	4	4	4	4	4	4	4	4	4	4	28	2	2	2	31	4	4	4	4	4	4	29	27	27	27	30	4	4	4	4	4	37	37	37	4	4	4	4	4	4	28	2	2	2	2
4	4	4	4	4	4	4	4	55	4	4	4	4	4	4	4	4	4	4	4	4	4	28	2	2	31	4	4	4	29	27	27	3	26	4	4	4	4	4	4	4	4	4	4	4	4	4	28	2	2	2	2	2	2	2	2	31	4	4	25	3	3	3	3
2	2	2	31	4	4	4	4	57	4	4	4	4	4	4	4	4	4	4	4	4	4	29	27	27	30	4	4	4	4	4	4	29	30	4	4	4	4	4	4	4	4	4	4	4	4	28	3	3	3	3	3	3	3	3	3	26	4	4	25	3	3	3	3
3	3	3	26	4	4	28	2	2	2	2	2	2	2	2	2	2	31	4	4	4	4	4	4	4	4	4	4	4	4	4	4	4	4	4	4	4	28	2	2	2	31	4	4	4	28	3	3	3	3	3	3	3	3	3	3	26	4	4	25	3	3	3	3
3	3	3	26	4	4	25	3	3	3	27	27	27	27	27	27	3	26	37	37	37	28	31	4	4	4	28	2	31	4	4	4	4	4	4	4	4	29	27	27	27	30	4	4	28	3	3	3	3	3	3	3	3	3	3	3	30	4	4	29	3	3	3	3
3	3	3	26	4	4	25	3	3	26	4	4	38	38	4	4	29	27	2	2	2	3	26	4	4	4	29	27	30	4	4	28	2	31	4	4	4	4	4	4	4	4	4	4	25	3	3	3	3	3	3	3	3	3	27	30	4	4	4	4	29	3	3	3
27	27	27	30	4	4	29	27	27	30	4	4	4	4	4	4	4	4	25	3	3	3	30	4	4	4	4	4	4	4	4	29	27	30	4	4	4	4	4	4	4	4	4	4	29	27	27	27	27	27	27	27	27	30	4	4	4	4	4	4	4	29	27	27
4	4	4	4	4	4	4	4	4	4	4	4	37	37	4	4	4	4	29	27	27	30	4	4	4	4	4	4	4	4	4	4	4	4	4	4	4	4	4	4	4	4	4	4	4	4	4	4	4	4	4	4	38	38	4	4	4	4	4	4	4	4	4	4
4	4	4	4	4	4	4	4	4	4	4	4	2	2	4	4	4	4	4	4	4	4	4	4	4	28	2	2	2	31	4	4	4	4	4	4	28	2	2	2	31	4	4	4	4	4	4	4	37	37	4	4	4	4	4	4	4	4	4	4	4	37	4	4
2	2	2	2	2	2	2	2	2	2	2	2	3	3	2	2	2	2	2	2	2	2	2	2	2	2	2	2	2	2	2	2	2	2	2	2	3	3	3	3	3	2	2	2	2	2	2	2	2	2	2	2	2	2	2	2	2	2	2	2	2	2	2	2
24 2833 0 1 2968 0 1 2591 0 1 2594 2 0 2795 0 1 2471 0 1 2407 0 1 2876 0 1 2808 2 0 2297 0 1 2155 0 1 2084 0 1 2051 2 0 1944 0 1 1709 0 1 1773 0 1 1630 0 1 1380 0 1 1094 0 1 260 2 0 196 2 0 776 2 0 85 0 1 149 0 1
82 2892 2 2893 2 2764 3 2765 3 2706 2 2707 2 2708 2 2191 2 2190 2 2182 2 2183 2 1862 3 1863 3 1864 3 1929 3 1930 3 1931 3 1932 3 1869 3 1870 3 1871 3 1872 3 1873 3 1874 3 1875 3 1876 3 1877 3 1878 3 1879 3 1699 2 1700 2 1690 2 1688 2 1685 2 1682 2 1679 2 1676 2 1672 2 1667 2 1548 3 1551 3 1554 3 1557 3 1560 3 1562 3 1152 2 1153 2 458 2 459 2 460 2 461 2 462 2 463 2 464 2 465 2 466 2 467 2 162 3 163 3 164 3 354 2 355 2 356 2 170 3 171 3 362 2 363 2 2096 2 2097 2 2098 2 2046 3 2289 3 2290 3 2291 3 2482 2 2483 2 2484 2 2992 2 2993 2 2932 3 2933 3 3005 2  
1 5040 240 map/Maze.map 0 1 1
0
175 2496 0 2497 0 2828 0 2829 0 2455 0 2456 0 2907 0 2651 0 2720 0 2398 0 2399 0 2144 0 2598 0 2345 0 2995 0 2937 0 2938 0 2873 0 2874 0 3007 0 2430 0 2431 0 2366 0 2367 0 2175 0 2174 0 2111 0 2110 0 1986 0 1985 0 1984 0 1758 0 1757 0 1756 0 1623 0 1620 0 1617 0 1614 0 1610 0 1665 0 1664 0 1601 0 1600 0 1024 0 1025 0 1035 0 1036 0 1037 0 1038 0 1099 0 1100 0 1101 0 1102 0 1176 0 1177 0 1240 0 1241 0 1073 0 1072 0 1074 0 1009 0 1137 0 764 0 765 0 828 0 829 0 704 0 705 0 64 0 65 0 66 0 139 0 140 0 141 0 142 0 331 0 332 0 333 0 334 0 235 0 236 0 299 0 300 0 1282 1 1283 1 1346 1 1347 1 322 1 323 1 386 1 387 1 2184 1 2185 1 2186 1 2187 1 2188 1 2189 1 1561 1 1625 1 1689 1 230 1 231 1 294 1 295 1 1597 1 1598 1 1599 1 1661 1 1662 1 1663 1 1011 1 1075 1 1139 1 1076 1 1077 1 1141 1 1013 1 2435 2 2436 2 2514 2 2515 2 1920 2 1921 2 1922 2 2062 2 2063 2 2064 2 1999 2 2000 2 2852 2 2853 2 2212 2 2214 2 2277 2 2340 2 2342 2 2931 2 2943 2 2295 2 2359 2 2358 2 2422 2 1611 2 1615 2 1618 2 1621 2 1624 2 1628 2 1629 2 1702 2 
1767 2 1832 2 1833 2 1274 2 1275 2 1338 2 1339 2 892 2 957 2 750 2 751 2 738 2 801 2 864 2 927 2 779 2 716 2 719 2 721 2 784 2 724 2 789 2 477 2 287 2 226 2
10 2433 2 2504 2568 2275 2 2074 2138 2388 2 2198 2199 2230 2 2364 2428 2037 3 1585 1649 1579 2 1910 1974 1537 2 1796 1797 1758 3 1885 1886 1034 2 794 795 385 2 243 307
12 893 3 0 1 957 3 0 1 694 1 1 2 756 0 1 3 690 1 1 2 687 1 1 2 686 1 1 2 978 1 1 2 975 1 1 2 972 1 1 2 1027 1 1 2 1212 3 0 1
79 2952 0 2821 1 2628 1 2508 1 2510 1 2445 1 2963 0 2964 0 2586 1 2782 1 2122 1 2058 1 2403 1 2600 0 2347 0 2858 1 1896 0 1898 0 2999 0 3002 0 2423 1 2172 0 1718 0 1721 0 1442 1 1249 1 1127 0 1393 0 1395 0 1396 0 1400 0 1401 0 1140 0 1138 0 1012 1 1010 1 947 1 759 0 754 0 748 0 745 0 742 0 240 1 239 1 366 1 296 1 166 1 1115 1 987 1 1170 0 1168 0 788 0 785 0 781 0 707 0 451 0 450 0 129 0 144 1 147 1 275 1 273 1 1219 2 1220 2 1285 2 1286 2 1039 2 1040 2 1052 2 989 2 198 2 263 2 200 2 201 2 265 2 472 2 602 2 540 2 414 2
0
0
dragon
4160 80 960 480
4560 320