27 27 27 27 03 03 27 27 27 27 27 27 27 27 27 27
04 04 04 36 25 26 04 04 04 04 04 04 04 04 04 04
04 04 04 04 29 30 04 04 04 04 04 04 04 04 04 04
04 04 04 04 04 04 04 28 31 04 28 31 04 04 04 04
02 31 42 04 04 04 40 25 26 37 25 26 04 04 28 02
03 03 02 02 02 02 02 03 03 02 03 30 04 04 29 03
27 27 27 27 27 27 27 27 27 27 30 04 04 04 04 29
04 04 04 04 04 04 04 04 04 04 04 04 04 04 04 04
04 04 04 04 04 04 04 04 04 04 04 04 04 04 04 04
04 04 04 04 04 04 04 28 02 02 02 02 02 02 02 02
04 04 04 04 28 02 02 03 03 03 03 03 03 03 03 03
02 31 04 04 25 03 03 03 03 03 03 03 03 03 03 03
03 26 04 04 25 03 27 27 27 27 27 27 27 27 03 03
03 30 04 04 29 30 04 04 04 04 04 04 04 36 25 03
30 04 04 04 04 04 04 04 04 04 04 04 04 04 29 03
04 04 04 04 04 04 04 04 04 04 04 04 04 04 04 29
04 04 04 04 04 04 04 04 28 31 35 04 04 04 04 04
02 02 02 02 02 02 02 02 03 30 35 04 04 04 04 04
03 03 03 03 03 03 03 03 30 42 04 04 04 28 02 02
27 27 27 27 27 27 27 30 04 04 04 04 04 29 27 27
04 04 04 04 04 04 04 04 04 04 04 04 04 04 04 36
04 04 04 04 04 04 04 04 04 04 04 04 04 04 04 36
04 04 04 04 04 04 04 04 04 40 28 02 02 02 02 02
02 02 02 02 02 02 02 02 02 02 03 03 03 03 03 03
1 361 0 1 297 2 0 254 0 1 70 0 1 66 2 0
1 351 1 335 1 282 0 266 0 221 1 73 2 19 1
1 0 120
0
1 57 160 161 62 63 349 350 333 334 52 53 68 69 144 145 156 171 172 173 188