27 27 27 27 03 03 27 27 27 27 27 27 27 27 27 27
04 04 04 04 25 26 04 04 04 04 04 04 04 04 04 04
04 04 04 04 29 30 04 04 04 04 04 04 04 04 04 04
04 04 04 04 04 04 04 28 31 04 28 31 04 04 04 04
02 31 04 04 04 04 04 25 26 04 25 26 04 04 28 02
03 03 02 02 02 02 02 03 03 02 03 30 04 04 29 03
27 27 27 27 27 27 27 27 27 27 30 04 04 04 04 29
04 04 04 04 04 04 04 04 04 04 04 04 04 04 04 04
04 04 04 04 04 04 04 04 04 04 04 04 04 04 04 04
04 04 04 04 04 04 04 28 02 02 02 02 02 02 02 02
04 04 04 04 28 02 02 03 03 03 03 03 03 03 03 03
02 31 04 04 25 03 03 03 03 03 03 03 03 03 03 03
03 26 04 04 25 03 27 27 27 27 27 27 27 27 03 03
03 30 04 04 29 30 04 04 04 04 04 04 04 21 25 03
30 04 04 04 04 04 04 04 04 04 04 04 04 04 29 03
04 04 04 04 04 04 04 04 04 04 04 04 04 04 04 29
04 04 04 04 04 04 04 04 28 31 20 04 04 04 04 04
02 02 02 02 02 02 02 02 03 30 20 04 04 04 04 04
03 03 03 03 03 03 03 03 30 04 04 04 04 28 02 02
27 27 27 27 27 27 27 30 04 04 04 04 04 29 27 27
04 04 04 04 04 04 04 04 04 04 04 04 04 04 04 21
04 04 04 04 04 04 04 04 04 04 04 04 04 04 04 21
04 04 04 04 04 04 04 04 04 04 28 02 02 02 02 02
02 02 02 02 02 02 02 02 02 02 03 03 03 03 03 03