27	27	27	27	27	27	27	27	27	27	27	27	27	27	27	27	27	27	27	27	27	27	3	3	3	3	3	3	3	3	3	27	27	27	3	3	3	27	27	27	27	3	3	3	3	27	27	27	27	3	3	3	27	27	27	27	27	27	27	27	27	27	27	27
4	4	4	4	4	4	4	4	4	4	4	4	4	4	4	4	4	4	4	4	4	40	25	3	3	3	3	3	3	3	26	4	4	4	29	27	30	4	4	4	4	29	27	27	30	4	4	4	4	29	3	3	4	4	4	4	4	4	4	4	4	4	4	4
4	4	4	4	4	4	4	4	4	4	4	4	4	4	4	4	4	4	4	4	4	40	29	3	3	3	3	3	3	3	30	4	4	4	38	38	38	4	4	4	4	4	38	38	4	4	4	4	4	4	29	27	4	4	4	4	4	4	4	4	4	2	2	2
2	2	2	31	42	4	4	4	4	4	4	28	2	2	31	4	4	4	4	4	4	4	4	29	3	3	3	3	3	30	4	4	4	4	4	4	4	4	4	4	4	4	4	4	4	4	4	4	4	4	4	55	4	4	4	4	2	2	2	4	4	4	4	4
3	27	27	30	42	4	4	4	4	4	4	29	27	27	30	4	4	4	4	4	4	4	4	4	29	3	3	3	30	4	4	4	4	4	4	4	4	4	4	4	4	4	4	4	4	4	4	4	4	4	4	57	4	2	2	4	4	4	4	4	4	4	4	4
26	4	4	4	4	4	4	4	4	4	4	4	4	4	4	4	4	4	4	4	4	4	4	4	4	29	27	30	4	4	4	4	4	4	37	37	37	4	4	4	4	4	37	37	4	4	4	4	4	4	28	2	4	4	4	4	4	4	4	4	4	4	4	4
26	4	4	4	4	4	4	4	4	4	4	4	4	4	4	4	4	4	4	4	4	4	4	4	4	4	43	43	4	4	4	4	4	4	28	2	31	4	4	4	4	28	2	2	31	4	4	4	4	28	3	3	4	4	4	4	4	4	4	4	4	4	4	4
26	4	4	4	4	4	4	4	28	31	37	37	37	37	37	37	37	37	37	37	28	31	4	4	4	4	4	4	4	4	4	4	28	2	3	3	3	2	2	2	2	3	3	3	2	2	2	2	3	3	3	3	2	2	2	2	2	2	2	2	2	2	2	2
3	2	2	2	2	31	4	4	25	3	2	2	2	2	2	2	2	2	2	2	3	26	4	4	4	4	4	4	4	4	4	28	3	3	3	3	3	3	3	3	3	3	3	3	3	3	3	3	3	3	3	3	3	3	3	3	3	3	3	3	3	3	3	3
27	27	27	27	27	30	4	4	29	3	3	3	3	3	3	3	3	3	3	3	3	30	4	4	4	4	4	4	4	4	28	3	3	3	27	27	27	27	27	27	27	27	27	27	27	27	27	27	27	27	27	27	27	27	27	27	27	27	27	27	27	27	27	27
4	4	4	4	4	4	4	4	4	29	27	27	27	27	27	27	27	27	27	27	27	4	4	4	4	4	4	4	4	28	3	3	3	30	4	4	4	4	4	4	4	4	4	4	4	4	4	4	4	4	4	4	4	4	4	4	4	4	4	4	4	4	4	4
4	4	4	4	4	4	4	4	4	4	4	4	4	4	4	4	4	4	4	4	4	4	4	4	28	31	4	4	28	3	3	3	30	4	4	4	4	4	4	4	4	4	4	4	4	4	4	4	4	4	4	4	4	4	4	4	4	4	4	4	4	4	4	4
2	2	2	2	2	2	2	2	42	4	4	4	4	4	4	4	4	4	4	4	4	4	4	28	3	26	60	62	25	3	3	30	4	4	4	4	28	2	2	2	2	2	2	2	31	4	4	4	4	28	2	2	2	2	2	31	4	4	4	4	4	4	4	4
3	3	3	3	3	3	3	3	2	2	2	2	2	2	2	2	2	2	2	2	2	2	2	3	3	26	4	4	29	27	30	4	4	4	4	28	3	3	3	3	3	3	3	3	3	31	4	4	28	3	27	27	27	27	27	3	2	4	4	4	4	4	28	2
3	3	3	3	3	3	3	3	3	3	3	27	27	27	27	27	27	27	27	27	3	3	3	3	3	26	4	4	4	4	4	4	4	4	28	3	3	3	3	3	3	3	3	3	3	3	2	2	3	30	4	4	4	4	4	29	27	30	4	4	4	4	25	3
27	27	27	27	27	27	3	3	3	3	30	4	4	4	4	4	4	4	4	4	29	3	3	3	3	26	4	4	4	4	4	4	4	28	3	27	27	27	27	27	27	27	27	27	3	3	3	3	30	4	4	4	4	4	4	4	4	4	4	4	28	2	3	3
4	4	4	4	4	4	29	3	3	30	4	4	4	4	4	4	4	4	4	4	4	29	27	27	27	30	4	4	4	4	4	4	28	3	30	4	4	4	4	4	4	4	4	4	29	3	3	26	4	4	4	4	4	4	4	4	4	4	4	4	25	3	3	3
4	4	4	4	4	4	40	29	30	4	4	4	4	4	4	4	4	4	4	4	4	4	4	4	4	4	4	4	4	4	4	28	3	30	4	4	4	4	4	4	4	4	4	4	4	29	3	3	31	4	4	4	4	4	4	28	31	4	4	4	29	3	3	3
37	37	4	4	4	4	4	4	43	4	4	4	4	4	4	4	4	4	4	4	4	4	4	4	4	4	4	4	4	4	28	3	26	4	4	4	4	28	2	2	2	31	4	4	4	4	29	3	3	2	2	2	2	2	2	3	30	4	4	4	4	29	3	3
2	31	4	4	4	4	4	4	4	4	4	4	28	2	2	2	2	2	2	2	2	2	31	4	4	4	4	4	4	28	3	3	26	4	4	4	4	25	3	3	3	3	31	4	4	4	4	29	27	27	27	27	27	27	27	30	4	4	4	4	4	4	29	27
3	26	4	4	4	4	4	4	4	4	4	28	3	3	3	3	3	3	3	3	3	3	3	31	4	4	4	4	28	3	3	3	26	4	4	4	4	25	3	3	3	3	3	31	4	4	4	4	4	4	4	4	4	4	4	4	4	4	4	4	4	4	4	4
3	26	4	4	4	4	4	4	4	4	28	3	3	3	3	3	3	3	3	3	3	3	3	3	2	2	2	2	3	3	3	3	26	4	4	4	40	29	3	3	3	3	3	3	31	4	4	4	4	4	4	4	4	4	4	4	4	4	4	4	4	4	4	4
3	3	2	31	4	4	28	2	2	3	3	3	3	3	3	3	3	3	3	3	3	3	3	3	3	3	3	3	3	3	3	3	26	4	4	4	4	4	29	3	3	3	3	3	3	2	2	2	2	2	2	2	2	2	2	2	2	2	2	2	2	2	2	2
3	27	27	30	4	4	29	27	27	27	27	27	27	27	27	27	27	27	27	27	27	27	27	27	27	27	27	27	27	27	27	3	26	4	4	4	4	4	4	29	3	3	3	27	27	27	27	27	27	27	27	27	27	27	27	27	27	27	27	27	27	27	27	27
30	4	4	4	4	4	4	4	4	4	4	4	38	4	4	38	4	4	38	4	4	38	4	4	38	4	38	4	4	4	4	25	26	4	4	4	4	4	4	4	25	3	26	4	4	4	4	4	4	55	4	4	4	4	4	4	4	4	4	4	4	4	4	4
4	4	4	4	4	4	4	4	4	4	4	4	4	4	4	4	4	4	4	4	4	4	4	4	4	4	4	4	4	4	40	25	26	4	4	4	4	4	4	4	29	3	26	4	4	4	4	4	4	57	4	4	4	4	4	4	4	4	4	4	4	4	4	4
4	4	4	37	4	4	28	31	37	4	4	4	37	4	4	37	4	4	37	4	4	37	4	4	37	4	37	4	4	4	4	25	26	4	4	37	37	4	4	4	4	29	30	4	4	40	28	2	2	2	2	2	31	4	4	4	4	4	4	4	4	4	4	4
2	2	2	31	4	4	25	3	2	2	2	2	2	2	2	2	2	2	2	2	2	2	2	2	2	2	31	4	4	4	4	25	26	4	4	28	31	4	4	4	4	4	4	4	4	40	29	3	3	3	3	3	3	2	2	2	2	2	2	31	4	28	31	4
3	3	3	30	60	62	29	27	27	3	3	3	3	27	27	27	27	27	27	27	27	27	27	27	3	3	3	31	4	4	4	25	26	4	4	25	26	4	4	4	4	4	4	4	4	4	4	25	3	3	3	3	3	27	27	27	27	3	3	26	4	25	3	2
27	27	30	4	4	4	38	38	38	29	27	27	30	38	38	38	38	38	38	38	38	38	38	38	29	3	3	3	31	60	62	25	26	4	4	25	3	2	31	4	4	4	4	4	4	4	4	29	27	27	27	27	30	4	55	4	4	29	27	30	4	25	3	27
4	4	4	4	4	4	4	4	4	38	38	38	38	4	4	4	4	4	4	4	4	4	4	4	40	29	3	3	30	4	4	29	30	4	4	29	3	3	3	2	2	2	2	31	4	4	4	4	4	4	4	4	4	4	57	4	4	4	4	4	4	29	30	4
4	4	4	4	4	4	4	4	4	4	4	4	4	4	4	4	4	4	4	4	4	4	4	4	4	4	29	30	4	4	4	4	4	4	4	4	29	3	3	3	3	3	3	3	2	4	4	4	4	4	4	4	4	4	28	31	4	4	4	4	4	4	38	4
2	2	31	42	4	4	4	4	4	4	4	4	4	4	4	4	4	4	28	2	2	31	4	4	4	4	55	4	4	4	4	4	4	4	4	4	40	29	27	27	27	27	27	27	3	31	4	4	37	37	37	4	4	28	3	3	2	2	2	4	4	4	4	4
3	3	3	2	31	4	4	4	4	4	4	4	4	4	4	4	4	28	3	3	3	26	4	4	4	4	57	4	4	4	4	4	4	4	4	4	4	4	4	4	4	4	4	40	29	3	2	2	2	2	2	2	2	3	27	27	27	3	3	31	4	4	4	4
3	3	3	3	3	31	37	37	4	4	4	4	4	4	37	37	28	3	3	3	3	26	60	62	28	2	2	2	31	4	4	28	2	2	31	4	4	4	4	4	4	4	4	4	4	29	27	27	27	27	27	27	27	30	4	4	4	29	3	3	2	2	2	2
3	3	3	3	3	3	2	2	2	2	2	2	2	2	2	2	3	3	3	3	3	30	4	4	29	27	27	27	30	4	4	29	27	27	30	4	4	4	4	4	4	4	4	4	4	4	4	4	4	38	38	38	4	4	4	4	4	40	29	27	27	27	27	27
3	3	3	3	3	3	3	3	3	3	3	3	27	27	27	27	3	3	3	3	30	4	4	4	4	4	4	4	4	4	4	4	4	4	4	4	4	4	4	4	4	4	4	4	4	4	4	4	4	4	4	4	4	4	4	4	4	4	4	4	55	4	4	4
3	27	27	27	27	27	3	3	3	3	3	30	4	4	4	4	29	27	27	30	4	4	4	4	4	4	4	4	4	4	4	4	4	4	4	4	4	4	4	40	28	2	2	2	31	4	4	4	4	4	4	4	4	4	4	4	4	4	4	4	57	4	4	4
30	4	4	4	4	4	29	27	27	27	30	4	4	4	4	4	4	4	4	4	4	4	4	4	4	4	4	4	4	28	2	2	2	31	4	4	4	4	4	40	29	27	27	27	30	4	4	4	4	4	37	37	37	4	4	4	4	4	4	28	2	2	2	2
4	4	4	4	4	4	4	4	55	4	4	4	4	4	4	4	4	4	4	4	4	4	28	2	2	31	4	4	4	29	27	27	3	26	4	4	4	4	4	4	4	4	4	4	4	4	4	28	2	2	2	2	2	2	2	2	31	4	4	25	3	3	3	3
2	2	2	31	4	4	4	4	57	4	4	4	4	4	4	4	4	4	4	4	4	4	29	27	27	30	4	4	4	4	4	40	29	30	42	4	4	4	4	4	4	4	4	4	4	4	28	3	3	3	3	3	3	3	3	3	26	4	4	25	3	3	3	3
3	3	3	26	4	4	28	2	2	2	2	2	2	2	2	2	2	31	4	4	4	4	4	4	4	4	4	4	4	4	4	4	4	4	4	4	4	28	2	2	2	31	4	4	4	28	3	3	3	3	3	3	3	3	3	3	26	4	4	25	3	3	3	3
3	3	3	26	4	4	25	3	3	3	27	27	27	27	27	27	3	26	37	37	37	28	31	4	4	4	28	2	31	4	4	4	4	4	4	4	4	29	27	27	27	30	4	4	28	3	3	3	3	3	3	3	3	3	3	3	30	4	4	29	3	3	3	3
3	3	3	26	4	4	25	3	3	26	4	4	38	38	4	4	29	27	2	2	2	3	26	4	4	4	29	27	30	4	4	28	2	31	4	4	4	4	4	4	4	4	4	40	25	3	3	3	3	3	3	3	3	3	27	30	42	4	4	4	29	3	3	3
27	27	27	30	4	4	29	27	27	30	4	4	4	4	4	4	4	40	25	3	3	3	30	4	4	4	4	4	4	4	4	29	27	30	4	4	4	4	4	4	4	4	4	4	29	27	27	27	27	27	27	27	27	30	4	4	4	4	4	4	40	29	27	27
4	4	4	4	4	4	4	4	4	4	4	4	37	37	4	4	4	4	29	27	27	30	4	4	4	4	4	4	4	4	4	4	4	4	4	4	4	4	4	4	4	4	4	4	4	4	4	4	4	4	4	4	38	38	4	4	4	4	4	4	4	4	4	4
4	4	4	4	4	4	4	4	4	4	4	4	2	2	4	4	4	4	4	4	4	4	4	4	40	28	2	2	2	31	4	4	4	4	4	4	28	2	2	2	31	4	4	4	4	4	4	4	37	37	4	4	4	4	4	4	4	4	4	4	4	37	4	4
2	2	2	2	2	2	2	2	2	2	2	2	3	3	2	2	2	2	2	2	2	2	2	2	2	2	2	2	2	2	2	2	2	2	2	2	3	3	3	3	3	2	2	2	2	2	2	2	2	2	2	2	2	2	2	2	2	2	2	2	2	2	2	2
0
82 2892 2 2893 2 2764 3 2765 3 2706 2 2707 2 2708 2 2191 2 2190 2 2182 2 2183 2 1862 3 1863 3 1864 3 1929 3 1930 3 1931 3 1932 3 1869 3 1870 3 1871 3 1872 3 1873 3 1874 3 1875 3 1876 3 1877 3 1878 3 1879 3 1699 2 1700 2 1690 2 1688 2 1685 2 1682 2 1679 2 1676 2 1672 2 1667 2 1548 3 1551 3 1554 3 1557 3 1560 3 1562 3 1152 2 1153 2 458 2 459 2 460 2 461 2 462 2 463 2 464 2 465 2 466 2 467 2 162 3 163 3 164 3 354 2 355 2 356 2 170 3 171 3 362 2 363 2 2096 2 2097 2 2098 2 2046 3 2289 3 2290 3 2291 3 2482 2 2483 2 2484 2 2992 2 2993 2 2932 3 2933 3 3005 2  
1 5040 240
0
83 2496 2497 2828 2829 2455 2456 2907 2651 2720 2398 2399 2144 2598 2345 2995 2937 2938 2873 2874 3007 2430 2431 2366 2367 2175 2174 2111 2110 1986 1985 1984 1758 1757 1756 1623 1620 1617 1614 1610 1665 1664 1601 1600 1024 1025 1035 1036 1037 1038 1099 1100 1101 1102 1176 1177 1240 1241 1073 1072 1074 1009 1137 764 765 828 829 704 705 64 65 66 139 140 141 142 331 332 333 334 235 236 299 300
10 2433 2 2504 2568 2275 2 2074 2138 2388 2 2198 2199 2230 2 2364 2428 2037 3 1585 1649 1579 2 1910 1974 1537 2 1796 1797 1758 3 1885 1886 1034 2 794 795 385 2 243 307
12 893 3 0 1 957 3 0 1 694 1 1 2 756 0 1 3 690 1 1 2 687 1 1 2 686 1 1 2 978 1 1 2 975 1 1 2 972 1 1 2 1027 1 1 2 1212 3 0 1
79 2952 0 2821 1 2628 1 2508 1 2510 1 2445 1 2963 0 2964 0 2586 1 2782 1 2122 1 2058 1 2403 1 2600 0 2347 0 2858 1 1896 0 1898 0 2999 0 3002 0 2423 1 2172 0 1718 0 1721 0 1442 1 1249 1 1127 0 1393 0 1395 0 1396 0 1400 0 1401 0 1140 0 1138 0 1012 1 1010 1 947 1 759 0 754 0 748 0 745 0 742 0 240 1 239 1 366 1 296 1 166 1 1115 1 987 1 1170 0 1168 0 788 0 785 0 781 0 707 0 451 0 450 0 129 0 144 1 147 1 275 1 273 1 1219 2 1220 2 1285 2 1286 2 1039 2 1040 2 1052 2 989 2 198 2 263 2 200 2 201 2 265 2 472 2 602 2 540 2 414 2
80 3680