03 27 27 27 27 27 27 27 27 27 03 03 27 27 27 27
04 04 04 04 04 04 04 04 04 04 25 26 04 04 04 04
04 04 04 04 04 04 04 04 04 04 25 26 04 04 04 04
04 04 04 04 04 04 04 04 04 04 29 03 02 31 04 04
04 04 28 02 31 04 04 04 04 04 04 29 03 26 04 04
04 04 29 27 30 04 04 04 04 04 04 04 25 26 04 04
04 04 04 04 04 04 04 04 04 04 04 04 25 26 04 04
04 04 04 04 04 28 02 31 04 04 04 04 25 26 04 04
04 04 28 31 04 29 27 30 04 04 04 04 25 26 04 04
04 04 25 26 04 04 04 04 04 04 04 04 04 04 04 04
04 04 25 26 04 04 04 04 04 04 04 04 04 04 04 04
02 02 03 03 02 02 02 02 02 02 02 31 04 04 04 04
27 27 27 27 27 27 27 27 27 27 27 30 04 04 04 04
04 04 04 04 04 04 04 04 04 04 04 04 04 04 04 04
04 04 04 04 04 04 04 04 04 04 04 04 04 04 28 02
04 04 04 04 04 04 04 04 04 04 04 04 04 04 29 27
04 04 04 04 04 04 04 04 04 04 04 04 04 04 04 04
04 04 04 04 04 04 04 28 02 31 04 04 04 04 04 04
04 04 04 04 04 04 04 25 03 26 04 04 04 04 04 04
04 04 28 02 31 04 04 25 03 26 04 04 04 04 28 02
04 04 25 03 26 04 04 25 03 26 04 04 04 04 29 27
04 04 25 03 26 04 04 21 03 20 04 04 04 04 04 04
04 04 25 03 26 04 04 21 03 20 04 04 04 04 04 04
02 02 03 03 03 02 02 03 03 03 02 02 02 02 02 02