03 27 27 27 27 27 27 27 27 27 03 03 27 27 27 27
04 04 04 04 04 04 04 04 04 40 25 26 04 04 04 04
04 04 04 04 04 04 04 04 04 40 25 26 37 37 04 04
04 04 04 04 04 04 04 04 04 04 29 03 02 31 04 04
04 04 28 02 31 04 04 04 04 04 04 29 03 26 04 04
04 04 29 27 30 04 04 04 04 04 04 04 25 26 04 04
04 04 04 04 04 04 04 04 04 04 04 04 25 26 04 04
04 04 04 04 04 28 02 31 04 04 04 04 25 26 04 04
04 04 28 31 04 29 27 30 04 04 04 04 25 26 04 04
04 04 25 26 04 04 04 04 04 04 04 04 04 04 04 04
04 04 25 26 04 04 04 04 04 04 04 04 04 04 04 04
02 02 03 03 02 02 02 02 02 02 02 31 04 04 04 04
27 27 27 27 27 27 27 27 27 27 27 30 42 04 04 04
04 04 04 04 04 04 04 04 04 04 04 04 04 04 04 04
04 04 04 04 04 04 04 04 04 04 04 04 04 04 28 02
04 04 04 04 04 04 04 04 04 04 04 04 04 40 29 27
04 04 04 04 04 04 04 04 04 04 04 04 04 04 04 04
04 04 04 04 04 04 04 28 02 31 04 04 04 04 04 04
04 04 04 04 04 04 04 25 03 26 42 04 04 04 04 04
04 04 28 02 31 04 04 25 03 26 04 04 04 04 28 02
04 04 25 03 26 04 04 25 03 26 04 04 04 04 29 27
04 04 25 03 26 04 04 36 03 35 04 04 04 04 04 04
04 04 25 03 26 37 04 36 03 35 04 04 04 04 04 04
02 02 03 03 03 02 02 03 03 03 02 02 02 02 02 02
1 298 2 0 253 0 1 41 0 1 25 0 1 204 2 0
1 359 1 361 0 343 1 345 0 44 2 45 2 357 2
1 0 670
0
1 28 29 34 35 50 51 52 101 102 103 342 358 303 302 287 322 323 295 296 297
80 1760
