06 06 06 06 06 06 06 06 06 06 06 06 06 06 06 06
06 14 14 14 14 14 14 06 14 14 14 06 14 14 14 06
06 14 14 14 14 14 14 06 14 14 14 06 14 52 52 06
06 14 14 14 14 06 14 14 14 06 14 14 14 06 06 06
06 52 14 14 14 06 14 14 14 06 47 14 14 14 14 06
06 06 14 14 06 06 06 06 06 06 06 06 06 14 14 06
14 14 14 14 14 14 06 14 14 14 14 14 14 14 14 48
52 52 14 14 14 14 06 14 14 06 06 06 06 06 06 06
06 06 06 06 14 14 06 14 14 06 14 14 14 14 14 06
14 14 14 14 14 14 06 14 14 06 14 14 14 14 14 06
14 14 14 14 14 14 06 14 14 06 14 14 14 14 14 06
45 45 14 14 14 14 06 14 14 06 14 14 06 14 14 14
06 06 06 06 06 14 06 14 14 06 14 14 06 14 14 14
06 14 14 14 06 14 06 14 14 06 14 14 06 14 14 45
06 14 14 14 06 14 06 14 14 06 14 14 53 14 14 06
06 14 06 06 06 14 06 14 14 06 14 14 14 14 14 06
06 14 14 06 14 14 06 14 14 14 14 14 52 14 14 06
06 14 14 06 14 14 06 14 14 14 14 14 06 14 14 06
14 14 14 06 14 14 06 14 14 14 14 14 06 14 14 14
14 14 14 06 06 06 06 06 06 06 06 06 06 14 14 14
45 14 14 14 14 14 14 14 14 14 14 14 14 14 14 45
13 13 14 14 14 14 14 14 14 14 14 14 14 14 12 12
13 13 13 14 14 14 14 14 14 14 14 14 14 12 12 12
06 06 06 06 06 06 06 06 06 06 06 06 06 06 06 06
0
1 65 2 45 2 46 2 112 2 113 2 268 2 236 3
1 320 1280
1 320 0 335 0 223 0 176 0 177 0 74 2 111 3
1 288 303 252 29 30 96 97 144 145 146 147 49 77 78 94 365 366 367 350 351
610 1760